concept_charactertrait_world	concept:atdate	concept_year_n1984
concept_charactertrait_heart_attack	concept:atdate	concept_dateliteral_n2008
concept_stateorprovince_wisconsin	concept:statelocatedingeopoliticallocation	concept_country_united_states
concept_mammal_kittens	concept:animalistypeofanimal	concept_animal_creatures
concept_televisionnetwork_abc	concept:companyeconomicsector	concept_academicfield_media
concept_sportsteam_rockets	concept:teamplaysagainstteam	concept_sportsteam_nuggets
concept_city_capital	concept:atdate	concept_year_n1998
concept_profession_health_care_professionals	concept:professionistypeofprofession	concept_profession_staff
concept_bakedgood_cake	concept:bakedgoodservedwithbeverage	concept_beverage_coffee
concept_website_issue	concept:atdate	concept_year_n1997
concept_musicalbum_days	concept:atdate	concept_dateliteral_n2007
concept_animal_hamsters	concept:animalpreyson	concept_mammal_small_animals
concept_sportsteam_packers	concept:teamalsoknownas	concept_sportsteam_new_orleans_saints
concept_lake_new	concept:locationlocatedwithinlocation	concept_city_newark
concept_profession_professionals	concept:professionistypeofprofession	concept_profession_researchers
concept_mammal_bears	concept:mammalsuchasmammal	concept_mammal_caribou
concept_company_adobe	concept:agentcreated	concept_visualizablething_use
concept_sportsteam_eagles	concept:teamplaysagainstteam	concept_sportsteam_florida_international
concept_person_mugabe	concept:agentcontrols	concept_personus_party
concept_city_centre	concept:atdate	concept_dateliteral_n2008
concept_profession_researchers	concept:professionistypeofprofession	concept_profession_practitioners
concept_sportsteam_bills	concept:teamplaysagainstteam	concept_sportsteam_steelers
concept_sportsteam_buffalo_bills	concept:teamplaysagainstteam	concept_sportsteam_sd_chargers
concept_language_english	concept:languageofcountry	concept_country_wales
concept_city_shanghai	concept:proxyfor	concept_country_china
concept_country_finland	concept:atdate	concept_dateliteral_n2002
concept_stateorprovince_states	concept:statelocatedingeopoliticallocation	concept_country_arabia_saudita
concept_chemical_water_vapor	concept:chemicalistypeofchemical	concept_chemical_carbon
concept_politician_obama	concept:agentcollaborateswithagent	concept_politicianus_president_bush
concept_bodypart_immune_system	concept:bodypartcontainsbodypart	concept_bodypart_tissue001
concept_bird_ducks	concept:animalistypeofanimal	concept_animal_fowl
concept_furniture_sinks	concept:furniturefoundinroom	concept_room_suite
concept_profession_educators	concept:professionistypeofprofession	concept_jobposition_nurse
concept_sportsteam_miami_dolphins	concept:agentparticipatedinevent	concept_convention_games
concept_city_auckland	concept:citylocatedingeopoliticallocation	concept_country_new_zealand
concept_lake_new	concept:locationlocatedwithinlocation	concept_country_arabia_saudita
concept_sportsteam_colorado_rockies	concept:teamplaysagainstteam	concept_sportsteam_red_sox
concept_profession_professions	concept:professionistypeofprofession	concept_profession_health
concept_chemical_carbon_dioxide	concept:chemicalistypeofchemical	concept_chemical_substances
concept_sportsteam_ravens	concept:teamplaysagainstteam	concept_sportsteam_new_york_giants
concept_animal_birds003	concept:animalistypeofanimal	concept_animal_mammals001
concept_city_geneva	concept:atdate	concept_dateliteral_n2008
concept_governmentorganization_fire	concept:atdate	concept_dateliteral_n2007
concept_sportsequipment_board	concept:synonymfor	concept_governmentorganization_management
concept_sport_rafting	concept:sportfansincountry	concept_country___america
concept_sportsteam_broncos	concept:teamplaysagainstteam	concept_sportsteam_colts
concept_stateorprovince_new_york	concept:statelocatedincountry	concept_country_usa
concept_country_democratic_republic_of_congo	concept:countryalsoknownas	concept_country_republic
concept_website_show	concept:atdate	concept_year_n1992
concept_grain_sugar	concept:agriculturalproductgrowinginstateorprovince	concept_stateorprovince_louisiana
concept_sportsgame_championship	concept:sportsgameteam	concept_sportsteam_knicks
concept_clothing_trousers	concept:clothingtogowithclothing	concept_clothing_socks
concept_country_republic	concept:countryalsoknownas	concept_country_somalia
concept_sportsteam_mariners	concept:teamplaysagainstteam	concept_sportsteam_texas_rangers
concept_politicianus_john_mccain	concept:politicianusmemberofpoliticalgroup	concept_governmentorganization_house
concept_language_english	concept:languageofcountry	concept_country_south_africa
concept_sportsteam_rockets	concept:teamplaysagainstteam	concept_sportsteam_orlando_magic
concept_profession_professionals	concept:professionistypeofprofession	concept_profession_instructors
concept_mammal_mammals	concept:animalpreyson	concept_animal_humans
concept_sportsleague_nba	concept:subpartoforganization	concept_sportsteam_suns
concept_newspaper_philadelphia_inquirer	concept:hasofficeincity	concept_city_new_york
concept_bathroomitem_tub	concept:itemfoundinroom	concept_visualizablething_bathrooms
concept_country_zimbabwe	concept:countryalsoknownas	concept_country_republic
concept_lake_new	concept:locationlocatedwithinlocation	concept_continent_africa
concept_city_parents	concept:atdate	concept_date_n2004
concept_city_army	concept:atdate	concept_date_n2001
concept_county_manhattan	concept:proxyfor	concept_coach_new
concept_person_george	concept:personhascitizenship	concept_country_greece
concept_sportsteam_chicago_white_sox	concept:teamplaysagainstteam	concept_sportsteam_tampa_bay_rays
concept_bank_dhl	concept:competeswith	concept_bank_priority_mail
concept_sport_sports	concept:sportusesequipment	concept_sportsequipment_equipment
concept_musicalbum_death	concept:atdate	concept_year_n1956
concept_politicsissue_public	concept:atdate	concept_year_n1989
concept_city_communities	concept:atdate	concept_date_n2004
concept_sportsteam_new_york_giants	concept:teamplaysagainstteam	concept_sportsteam_philadelphia_athletics
concept_sportsteam_dallas_cowboys	concept:teamplaysagainstteam	concept_sportsteam_carolina_panthers
concept_country_china	concept:atdate	concept_dateliteral_n2006
concept_bedroomitem_bath	concept:itemfoundinroom	concept_visualizablething_master_suite
concept_website_market	concept:atdate	concept_dateliteral_n2008
concept_eventoutcome_practice	concept:atdate	concept_date_n2001
concept_person_george	concept:personmovedtostateorprovince	concept_stateorprovince_new_jersey
concept_insect_mealy_bugs	concept:animalthatfeedoninsect	concept_insect_insects
concept_sportsteam_cleveland_browns	concept:teamplaysagainstteam	concept_sportsteam_bills
concept_politicsissue_public	concept:atdate	concept_dateliteral_n1987
concept_bird_eagles	concept:animalpreyson	concept_arthropod_prey
concept_mammal_big_cats	concept:animalistypeofanimal	concept_mammal_pets
concept_city_link	concept:agentcreated	concept_programminglanguage_contact
concept_sportsteam_san_antonio	concept:teamplaysagainstteam	concept_sportsteam_nuggets
concept_musicsong_plan	concept:istallerthan	concept_publication_people_
concept_chemical_companies	concept:atdate	concept_dateliteral_n2002
concept_weapon_arms	concept:weaponmadeincountry	concept_country_west_indies
concept_language_spanish	concept:languageofcountry	concept_country_peru
concept_city_moscow	concept:atdate	concept_year_n1992
concept_person_charles001	concept:personchargedwithcrime	concept_crimeorcharge_treason
concept_website_amazon	concept:competeswith	concept_website_yahoo
concept_sportsteam_washington_wizards	concept:teamplaysinleague	concept_sportsleague_nba
concept_sportsteam_florida_gators	concept:teamplaysinleague	concept_sportsleague_ncaa
concept_sportsgame_series	concept:sportsgameteam	concept_sportsteam_chicago_white_sox
concept_boardgame_board	concept:atdate	concept_dateliteral_n2008
concept_bodypart_system001	concept:bodypartcontainsbodypart	concept_artery_vessels
concept_city_york	concept:atlocation	concept_stateorprovince_new_york
concept_vertebrate_page	concept:specializationof	concept_mammal_dogs
concept_sportsteam_sd_chargers	concept:teamplaysagainstteam	concept_sportsteam_titans
concept_cognitiveactions_studies	concept:atdate	concept_dateliteral_n2005
concept_sportsteam_penn_state	concept:teamplaysinleague	concept_sportsleague_ncaa
concept_sportsteam_chicago_white_sox	concept:teamplaysagainstteam	concept_sportsteam_mariners
concept_sportsteam_maple_leafs	concept:teamwontrophy	concept_awardtrophytournament_stanley_cup
concept_sportsteam_rams	concept:teamplaysagainstteam	concept_sportsteam_seahawks
concept_governmentorganization_program	concept:subpartof	concept_visualizablething_water_supply
concept_sportsteam_ncaa_youth_kids	concept:agentcompeteswithagent	concept_city_washington_d_c
concept_geometricshape_shape	concept:atdate	concept_dateliteral_n2007
concept_country_bosnia_herzegovina	concept:countryalsoknownas	concept_country_republic
concept_sportsteam_florida_international	concept:teamplaysagainstteam	concept_sportsteam_philadelphia_eagles
concept_sport_basketball	concept:sportfansincountry	concept_country_china
concept_company_adobe	concept:agentinvolvedwithitem	concept_buildingfeature_windows
concept_geopoliticallocation_iraq	concept:atdate	concept_dateliteral_n2008
concept_sportsteam_yanks	concept:teamplaysagainstteam	concept_sportsteam_tampa_bay_devil_rays
concept_automobilemaker_chevrolet	concept:automobilemakercardealersinstateorprovince	concept_stateorprovince_maine
concept_geopoliticallocation_form	concept:atdate	concept_dateliteral_n2002
concept_newspaper_daily	concept:competeswith	concept_company_telegraph001
concept_invertebrate_slugs	concept:animalsuchasinvertebrate	concept_insect_pests
concept_company_new_york	concept:agentactsinlocation	concept_lake_new
concept_musicalbum_power	concept:atdate	concept_dateliteral_n2008
concept_company_los_angeles	concept:competeswith	concept_website_chicago_tribune
concept_personmexico_ncaa	concept:agentcontrols	concept_sportsteam_louisville_cardinals
concept_agriculturalproduct_products	concept:agriculturalproductincludingagriculturalproduct	concept_vegetable_rice
concept_city_princeton	concept:locationlocatedwithinlocation	concept_stateorprovince_west_virginia
concept_sportsteam_rockets	concept:teamplaysagainstteam	concept_sportsteam_suns
concept_clothing_pants	concept:clothingtogowithclothing	concept_clothing_t_shirt
concept_sportsteam_dundee_united	concept:teamplaysagainstteam	concept_sportsteam_new_york_jets
concept_country_dominican_republic	concept:atdate	concept_dateliteral_n2008
concept_geopoliticalorganization_northern	concept:agentactsinlocation	concept_continent_africa
concept_musicartist_times	concept:agentinvolvedwithitem	concept_buildingfeature_window
concept_stateorprovince_training	concept:atdate	concept_date_n1996
concept_automobilemaker_acura	concept:automobilemakercardealersinstateorprovince	concept_stateorprovince_texas
concept_clothing_gloves	concept:clothingtogowithclothing	concept_clothing_shoes
concept_sportsteam_twins	concept:teamplaysagainstteam	concept_sportsteam_texas_rangers
concept_city_web	concept:atdate	concept_date_n2003
concept_city_area	concept:atdate	concept_year_n1988
concept_terroristorganization_state	concept:organizationterminatedperson	concept_scientist_no_
concept_governmentorganization_house	concept:atdate	concept_month_october
concept_book_stay	concept:atdate	concept_month_february
concept_profession_workers	concept:professionistypeofprofession	concept_profession_dentists
concept_county_utah	concept:atdate	concept_dateliteral_n2007
concept_sportsteam_red_sox_this_season	concept:teamplaysagainstteam	concept_sportsteam_red_sox
concept_athlete_playoff	concept:atdate	concept_date_n2001
concept_insect_insects	concept:animalpreyson	concept_mammal_small_animals
concept_company_new_york	concept:mutualproxyfor	concept_county_manhattan
concept_language_english	concept:languageofcountry	concept_country_pakistan
concept_automobilemaker_hyundai	concept:automobilemakerdealersincity	concept_city_san_diego
concept_city_washington_d_c	concept:citylocatedingeopoliticallocation	concept_country_us
concept_sportsteam_red_sox	concept:teamplaysagainstteam	concept_sportsteam_oakland_athletics
concept_clothing_hats	concept:clothingtogowithclothing	concept_clothing_boots
concept_sport_ski	concept:sportschoolincountry	concept_country_new_zealand
concept_city_father	concept:atdate	concept_dateliteral_n2005
concept_chemical_nitrogen_oxides	concept:chemicalistypeofchemical	concept_chemical_sulphur
concept_city_home	concept:atdate	concept_month_april
concept_city_madrid	concept:atdate	concept_date_n2004
concept_city_rome	concept:atdate	concept_date_n2004
concept_website_the_san_francisco_chronicle	concept:hasofficeincity	concept_city_new_york
concept_musicartist_arrival	concept:atdate	concept_year_n1998
concept_male_david	concept:journalistwritesforpublication	concept_website_new_york_times
concept_sportsgame_championship	concept:atdate	concept_dateliteral_n1990
concept_sportsteam_new_orleans_saints	concept:subpartoforganization	concept_sportsleague_nba
concept_country_united_states	concept:organizationacronymhasname	concept_governmentorganization_united_states_department
concept_sport_football	concept:sportschoolincountry	concept_country_uk
concept_island_operations	concept:atdate	concept_dateliteral_n1987
concept_sportsteam_phillies	concept:teamplaysinleague	concept_sportsleague_mlb
concept_videogame_nights	concept:atlocation	concept_hotel_north
concept_country_poland	concept:atdate	concept_date_n2000
concept_mammal_elephants	concept:animalistypeofanimal	concept_mammal_animals
concept_politicianus_john_kerry	concept:agentcollaborateswithagent	concept_politician_obama
concept_stateorprovince_states	concept:statelocatedingeopoliticallocation	concept_county_seattle
concept_sportsteam_florida_international	concept:teamplaysagainstteam	concept_sportsteam_buccaneers
concept_mammal_small_pets	concept:animalistypeofanimal	concept_mammal_ferrets
concept_clothing_skirt	concept:clothingtogowithclothing	concept_visualizableobject_coat
concept_country_sweden	concept:countrylocatedingeopoliticallocation	concept_country_region
concept_sportsteam_titans	concept:teamplaysagainstteam	concept_sportsteam_kansas_city_chiefs
concept_programminglanguage_collection	concept:atdate	concept_year_n1991
concept_governmentorganization_house	concept:atdate	concept_date_n2000
concept_reptile_cat	concept:specializationof	concept_animal_animals002
concept_person_james001	concept:personhascitizenship	concept_country_ireland
concept_city_link	concept:organizationhiredperson	concept_personmexico_ryan_whitney
concept_televisionshow_saturday	concept:atdate	concept_dateliteral_n2007
concept_bank_the_national	concept:agentactsinlocation	concept_country_usa
concept_country_armenia	concept:atdate	concept_dateliteral_n2006
concept_county_york_city	concept:locationlocatedwithinlocation	concept_country_u_s_
concept_sportsteam_red_sox	concept:teamplaysagainstteam	concept_sportsteam_chowan_braves
concept_visualizablething_triangle	concept:thinghasshape	concept_geometricshape_shape
concept_governmentorganization_regulations	concept:agentparticipatedinevent	concept_eventoutcome_result
concept_person_prince	concept:personhascitizenship	concept_country_portugal
concept_stateorprovince_states	concept:statelocatedingeopoliticallocation	concept_city_capital
concept_company_national	concept:hasofficeincountry	concept_country_china
concept_insect_insects	concept:arthropodcalledarthropod	concept_insect_ladybugs
concept_city_london_city	concept:atdate	concept_dateliteral_n2002
concept_city_title	concept:atdate	concept_date_n1996
concept_country_philippines	concept:atdate	concept_date_n2004
concept_sportsteam_bills	concept:teamplaysagainstteam	concept_sportsteam_falcons
concept_sportsteam_oakland_raiders	concept:teamplaysagainstteam	concept_sportsteam_seahawks
concept_university_state_university	concept:synonymfor	concept_county_miami
concept_politician_president_george_w_	concept:politicianholdsoffice	concept_politicaloffice_office
concept_country_haiti	concept:atdate	concept_dateliteral_n2007
concept_country_mozambique	concept:atdate	concept_date_n2000
concept_creditunion_michigan	concept:subpartoforganization	concept_sportsteam_ncaa_youth_kids
concept_sportsteam_knicks	concept:agentparticipatedinevent	concept_convention_games
concept_televisionnetwork_abc	concept:competeswith	concept_newspaper_journal
concept_county_los_angeles_county	concept:cityliesonriver	concept_river_columbia
concept_academicfield_computer_science	concept:academicprogramatuniversity	concept_university_state_university
concept_city_team	concept:atdate	concept_dateliteral_n2007
concept_visualizableobject_shirt	concept:clothingtogowithclothing	concept_clothing_clothes
concept_language_arabic	concept:languageofcountry	concept_country_egypt
concept_chemical_molecules	concept:chemicalistypeofchemical	concept_chemical_chlorine
concept_male_years	concept:agentactsinlocation	concept_city_central
concept_city_johannesburg	concept:atdate	concept_dateliteral_n2002
concept_city_bellevue	concept:cityliesonriver	concept_attraction_mississippi
concept_male_history	concept:atdate	concept_dateliteral_n2008
concept_animal_students	concept:animaldevelopdisease	concept_disease_disorders
concept_mammal_dogs	concept:animalpreyson	concept_mammal_small_animals
concept_museum_pbs	concept:atdate	concept_dateliteral_n2002
concept_visualizablething_residence	concept:atdate	concept_month_march
concept_physicalaction_work	concept:atdate	concept_date_n2001
concept_company_oracle	concept:competeswith	concept_company_ibm
concept_city_cleveland	concept:citylocatedinstate	concept_stateorprovince_ohio
concept_animal_humans	concept:animalistypeofanimal	concept_animal_beasts
concept_sportsteam_brewers	concept:teamplaysagainstteam	concept_sportsteam_st___louis_cardinals
concept_sportsgame_series	concept:sportsgameteam	concept_sportsteam_red_sox
concept_academicfield_physics	concept:atdate	concept_dateliteral_n2008
concept_sportsteam_broncos	concept:teamplaysagainstteam	concept_sportsteam_oakland_raiders
concept_invertebrate_teens	concept:animaldevelopdisease	concept_disease_problems
concept_director_committee	concept:atdate	concept_date_n2001
concept_profession_staff	concept:professionistypeofprofession	concept_profession_counselors
concept_animal_birds002	concept:animalistypeofanimal	concept_animal_creatures
concept_city_army	concept:subpartoforganization	concept_sportsteam_ncaa_youth_kids
concept_animal_mice001	concept:animalistypeofanimal	concept_reptile_pets
concept_city_washington_d_c	concept:citylocatedinstate	concept_stateorprovince_rhode_island
concept_university_ministry	concept:atdate	concept_date_n1996
concept_language_spanish	concept:languageofcountry	concept_country_colombia
concept_newspaper_tribune	concept:newspaperincity	concept_city_new_york
concept_artery_aorta	concept:arterycalledartery	concept_artery_arteries
concept_profession_staff	concept:professionistypeofprofession	concept_profession_clients
concept_politicianus_president_obama	concept:agentbelongstoorganization	concept_politicalparty_house
concept_landscapefeatures_states	concept:locationlocatedwithinlocation	concept_governmentorganization_european_union
concept_book_evening	concept:atdate	concept_dateliteral_n2008
concept_mammal_bears	concept:animalpreyson	concept_animal_carnivores
concept_musicsong_spain	concept:atdate	concept_dateliteral_n2008
concept_agriculturalproduct_livestock	concept:animalistypeofanimal	concept_mammal_cows
concept_year_new	concept:mutualproxyfor	concept_geopoliticalorganization_customers
concept_currency_dollars	concept:atdate	concept_dateliteral_n2008
concept_fish_salmon	concept:fishservedwithfood	concept_vegetable_spinach
concept_politician_obama	concept:agentcollaborateswithagent	concept_politicianus_john_kerry
concept_politicianus_rodham_clinton	concept:agentcollaborateswithagent	concept_person_bill
concept_language_english	concept:languageofcountry	concept_country_uganda
concept_sportsteam_suns	concept:teamplaysagainstteam	concept_sportsteam_dallas_mavericks
concept_hotel_north	concept:locationlocatedwithinlocation	concept_stateorprovince_california
concept_city_web	concept:atdate	concept_month_july
concept_sportsteam_twins	concept:teamplaysinleague	concept_sportsleague_mlb
concept_city_web	concept:atdate	concept_date_n1999
concept_book_stay	concept:atdate	concept_date_n2004
concept_academicfield_computer_science	concept:atdate	concept_year_n1997
concept_clothing_shorts	concept:clothingtogowithclothing	concept_clothing_black_shirt
concept_sportsteam_saints	concept:teamplaysagainstteam	concept_sportsteam_bucs
concept_city_resources	concept:agentcompeteswithagent	concept_tradeunion_search
concept_sportsteam_eagles	concept:teamplaysagainstteam	concept_sportsteam_bucs
concept_insect_mites	concept:animalsuchasinvertebrate	concept_insect_insect_pests
concept_disease_breast_cancer	concept:atdate	concept_year_n1998
concept_city_army	concept:atdate	concept_year_n1919
concept_sportsteam_new_york_giants	concept:teamplaysagainstteam	concept_sportsteam_redskins
concept_visualartmovement_britain	concept:atdate	concept_year_n1991
concept_city_uk	concept:atdate	concept_year_n1982
concept_comedian_day	concept:atdate	concept_year_n1991
concept_politicianus_mccain	concept:politicianusendorsedbypoliticianus	concept_politicianus_president_george_w__bush
concept_insect_moths	concept:arthropodandotherarthropod	concept_insect_pests
concept_musicartist_american	concept:agentactsinlocation	concept_county_los_angeles_county
concept_sport_ski	concept:sportschoolincountry	concept_country_czech_republic
concept_university_administration	concept:atdate	concept_year_n1995
concept_lake_new	concept:locationlocatedwithinlocation	concept_county_seattle
concept_country_republic	concept:countryalsoknownas	concept_country_australia
concept_hobby_studio	concept:proxyfor	concept_book_new
concept_musicalbum_child	concept:atdate	concept_dateliteral_n2002
concept_governmentorganization_governments	concept:atdate	concept_date_n2000
concept_personus_officials	concept:agentcollaborateswithagent	concept_biotechcompany_white
concept_book_america	concept:atdate	concept_year_n1997
concept_clothing_shirts	concept:clothingtogowithclothing	concept_clothing_suit
concept_visualizablething_use	concept:subpartoforganization	concept_blog_form
concept_country_republic	concept:countryalsoknownas	concept_country_scandinavian_countries
concept_athlete_playoff	concept:atdate	concept_dateliteral_n2005
concept_sportsteam_san_antonio	concept:teamplaysagainstteam	concept_sportsteam_suns
concept_country_republic	concept:countryalsoknownas	concept_country_dominican_republic
concept_personmexico_ryan_whitney	concept:persongraduatedschool	concept_university_college
concept_lake_new	concept:mutualproxyfor	concept_sportsteam_germany
concept_musicalbum_review	concept:atdate	concept_date_n1999
concept_eventoutcome_practice	concept:atdate	concept_date_n1999
concept_month_november	concept:atdate	concept_date_meeting
concept_country_egypt	concept:atdate	concept_dateliteral_n2002
concept_clothing_shirts	concept:clothingtogowithclothing	concept_clothing_hat
concept_city_bush	concept:agentparticipatedinevent	concept_crimeorcharge_crimes
concept_automobilemaker_honda	concept:automobilemakerdealersincity	concept_city_san_antonio
concept_mammal_kids	concept:animaldevelopdisease	concept_disease_illness
concept_food_peppers	concept:agriculturalproductcookedwithagriculturalproduct	concept_vegetable_peas
concept_profession_workers	concept:professionistypeofprofession	concept_profession_researchers
concept_automobilemaker_nissan	concept:automobilemakerdealersincity	concept_city_york
concept_stateorprovince_states	concept:statelocatedingeopoliticallocation	concept_country_new_zealand
concept_country_brazil	concept:atdate	concept_dateliteral_n2006
concept_visualizablething_residence	concept:proxyfor	concept_lake_new
concept_sport_rugby	concept:sportfansincountry	concept_country_south_africa
concept_animal_child	concept:animaldevelopdisease	concept_disease_diseases
concept_city_jerusalem	concept:atdate	concept_dateliteral_n2002
concept_company_hsbc	concept:hasofficeincountry	concept_country_lebanon
concept_sportsteam_colts	concept:teamplaysagainstteam	concept_sportsteam_broncos
concept_governmentorganization_nation	concept:atdate	concept_date_n2003
concept_vertebrate_page	concept:specializationof	concept_animal_creatures
concept_clothing_jacket	concept:clothingtogowithclothing	concept_clothing_hat
concept_animal_creatures	concept:animalsuchasinsect	concept_insect_moths
concept_weapon_national	concept:atlocation	concept_county_detroit
concept_sportsteam_bucs	concept:teamplaysagainstteam	concept_sportsteam_oakland_raiders
concept_geopoliticallocation_surgery	concept:atdate	concept_year_n1998
concept_city_download	concept:atdate	concept_dateliteral_n2008
concept_boardgame_board	concept:atdate	concept_dateliteral_n2002
concept_buildingfeature_doors	concept:atdate	concept_dateliteral_n2006
concept_mammal_cows	concept:agentparticipatedinevent	concept_eventoutcome_result
concept_animal_animals001	concept:animalsuchasinvertebrate	concept_arthropod_raccoons
concept_sportsteam_houston_texans	concept:agentparticipatedinevent	concept_convention_games
concept_governmentorganization_health	concept:atdate	concept_date_n2009
concept_country_ghana	concept:atdate	concept_date_n2001
concept_insect_pests	concept:animalthatfeedoninsect	concept_insect_moths
concept_newspaper_new_york_post	concept:headquarteredin	concept_city_new_york
concept_city_york	concept:subpartof	concept_musicalbum_us
concept_sportsteam_redskins	concept:teamplaysagainstteam	concept_sportsteam_florida_international
concept_governmentorganization_investigation	concept:atdate	concept_date_n2003
concept_sportsteam_timberwolves	concept:teamplaysagainstteam	concept_sportsteam_suns
concept_sportsteam_indiana_pacers	concept:teamplayssport	concept_sport_basketball
concept_animal_birds002	concept:specializationof	concept_animal_creatures
concept_city_place	concept:atdate	concept_year_n1991
concept_mammal_bear	concept:mammalsuchasmammal	concept_mammal_wolves
concept_musicartist_american	concept:agentactsinlocation	concept_county_baltimore
concept_emotion_mississippi	concept:proxyfor	concept_book_new
concept_sportsteam_dodgers	concept:teamplaysinleague	concept_sportsleague_mlb
concept_city_place	concept:atdate	concept_year_n1862
concept_company_daily_news001	concept:competeswith	concept_website_san_jose_mercury_news
concept_programminglanguage_stroke	concept:atdate	concept_dateliteral_n2002
concept_politicsissue_students	concept:atdate	concept_year_n1992
concept_politicianus_nancy_pelosi	concept:politicianusmemberofpoliticalgroup	concept_governmentorganization_house
concept_wallitem_beginning	concept:atdate	concept_date_n2001
concept_politicianus_george_w__bush	concept:politicianusholdsoffice	concept_politicaloffice_secretary
concept_jobposition_nursing	concept:professionistypeofprofession	concept_profession_staff
concept_country_ghana	concept:countrylocatedingeopoliticallocation	concept_country_countries
concept_politicsbill_complaint	concept:atdate	concept_year_n1992
concept_country_scandinavian_countries	concept:countryalsoknownas	concept_country_republic
concept_sportsgame_games	concept:sportsgameteam	concept_sportsteam_cavs
concept_country_czech_republic	concept:atdate	concept_date_n2001
concept_city_paris	concept:citylocatedingeopoliticallocation	concept_geopoliticallocation_national
concept_sportsteam_ravens	concept:teamplaysagainstteam	concept_sportsteam_seahawks
concept_island_iceland	concept:countryalsoknownas	concept_country_republic
concept_politicianus_nixon	concept:politicianusendorsedbypoliticianus	concept_politicianus_bush
concept_sportsteam_carolina_panthers	concept:organizationheadquarteredinstateorprovince	concept_stateorprovince_new_york
concept_city_jacksonville	concept:atlocation	concept_stateorprovince_alabama
concept_insect_insects	concept:arthropodandotherarthropod	concept_insect_ladybugs
concept_city_stockholm	concept:atdate	concept_dateliteral_n2008
concept_city_sweden	concept:mutualproxyfor	concept_city_stockholm
concept_sportsteam_steelers	concept:teamplaysagainstteam	concept_sportsteam_broncos
concept_stateorprovince_pennsylvania	concept:mutualproxyfor	concept_county_philadelphia
concept_hobby_studio	concept:atdate	concept_date_n2000
concept_sportsteam_spurs	concept:teamplaysagainstteam	concept_sportsteam_cavs
concept_city_columbia	concept:cityalsoknownas	concept_city_toronto
concept_sportsteam_kansas_city_chiefs	concept:teamplaysagainstteam	concept_sportsteam_packers
concept_city_madrid	concept:atdate	concept_year_n1995
concept_nerve_nervous_system	concept:bodypartcontainsbodypart	concept_bodypart_cells001
concept_country_croatia	concept:atdate	concept_year_n1991
concept_mammal_rabbits	concept:specializationof	concept_mammal_small_animals
concept_city_web	concept:atdate	concept_year_n1998
concept_profession_staff	concept:professionistypeofprofession	concept_profession_doctors
concept_company_apple002	concept:companyalsoknownas	concept_biotechcompany_apple
concept_book_amsterdam	concept:atdate	concept_date_n2004
concept_profession_staff	concept:professionistypeofprofession	concept_profession_craftsmen
concept_geometricshape_course	concept:atdate	concept_year_n1991
concept_sportsteam_reds	concept:teamplaysinleague	concept_sportsleague_mlb
concept_weapon_weapons	concept:weaponmadeincountry	concept_country_iran
concept_bird_chickens	concept:animalistypeofanimal	concept_animal_poultry
concept_bank_national	concept:bankbankincountry	concept_country_papua_new_guinea
concept_country_republic	concept:countryalsoknownas	concept_country_sudan
concept_city_title	concept:atdate	concept_year_n1997
concept_person_stephen	concept:personbornincity	concept_city_york
concept_person_president	concept:agentbelongstoorganization	concept_politicalparty_house
concept_country_usa	concept:countryalsoknownas	concept_country___america
concept_sportsteam_red_sox	concept:teamplaysagainstteam	concept_sportsteam_chicago_cubs
concept_website_introduction	concept:atdate	concept_dateliteral_n2008
concept_mammal_dogs	concept:animalistypeofanimal	concept_animal_large_animals
concept_sportsteam_nuggets	concept:teamplaysinleague	concept_sportsleague_nba
concept_city_washington_d_c	concept:agentcontrols	concept_clothing_white
concept_vegetable_onion	concept:agriculturalproductcookedwithagriculturalproduct	concept_agriculturalproduct_red_pepper
concept_clothing_socks	concept:clothingtogowithclothing	concept_clothing_jeans
concept_buildingfeature_american	concept:atlocation	concept_city_toronto
concept_mammal_tigers	concept:animalistypeofanimal	concept_mammal_pets
concept_country_tanzania	concept:atdate	concept_dateliteral_n2002
concept_country_party	concept:atdate	concept_dateliteral_n2002
concept_university_administration	concept:atdate	concept_date_n2004
concept_nongovorganization_forces	concept:atdate	concept_dateliteral_n1950
concept_country_sri_lanka	concept:countryalsoknownas	concept_country_republic
concept_buildingfeature_american	concept:atlocation	concept_visualizablescene_ny
concept_musicsong_night	concept:atdate	concept_year_n1982
concept_geopoliticallocation_national	concept:atlocation	concept_city_tucson
concept_country_ghana	concept:countrylocatedingeopoliticallocation	concept_stateorprovince_states
concept_profession_workers	concept:professionistypeofprofession	concept_profession_staff
concept_sportsteam_titans	concept:teamplaysagainstteam	concept_sportsteam_sd_chargers
concept_lake_new	concept:locationlocatedwithinlocation	concept_city_rio
concept_artery_fluid	concept:bodypartcontainsbodypart	concept_artery_cord
concept_company_new_york	concept:proxyfor	concept_room_south
concept_coach_new	concept:subpartof	concept_weapon_weeks
concept_website_new_york_daily	concept:organizationheadquarteredincity	concept_city_new_york
concept_sportsgame_games	concept:sportsgameteam	concept_sportsteam_detroit_lions
concept_city_greenville	concept:atlocation	concept_stateorprovince_ohio
concept_mammal_mammals	concept:animalpreyson	concept_mammal_rabbits
concept_island_operations	concept:atdate	concept_date_n2001
concept_nonneginteger_one	concept:atdate	concept_year_n1992
concept_mammal_ferrets	concept:animalistypeofanimal	concept_mammal_mammals
concept_chemical_gas	concept:chemicalistypeofchemical	concept_chemical_water_vapor
concept_academicfield_trial	concept:atdate	concept_year_n1982
concept_arthropod_prey	concept:animalsuchasinsect	concept_insect_insects
concept_city_toronto	concept:cityalsoknownas	concept_city_columbia
concept_sportsteam_red_sox	concept:teamplaysagainstteam	concept_sportsteam_toronto_blue_jays
concept_country_united_states	concept:atdate	concept_dateliteral_n2008
concept_sportsteam_cleveland_indians_organization	concept:teamplaysagainstteam	concept_sportsteam_texas_rangers
concept_clothing_socks	concept:clothingtogowithclothing	concept_clothing_shirts
concept_governmentorganization_house	concept:atdate	concept_dayofweek_monday
concept_artery_cord	concept:bodypartcontainsbodypart	concept_artery_fluid
concept_university_administration	concept:atdate	concept_dateliteral_n2005
concept_animal_herbivores	concept:animalistypeofanimal	concept_mammal_rabbits
concept_sportsteam_timberwolves	concept:teamplaysagainstteam	concept_sportsteam_bucks
concept_biotechcompany_white	concept:agentcollaborateswithagent	concept_personus_officials
concept_arthropod_prey	concept:animalpreyson	concept_mammal_rodents
concept_insect_caterpillars	concept:invertebratefeedonfood	concept_food_foliage
concept_sportsteam_bears_29_17	concept:teamplaysagainstteam	concept_sportsteam_oakland_raiders
concept_language_spanish	concept:languageofcountry	concept_country_spain
concept_city_home	concept:subpartof	concept_stateorprovince_contact
concept_politician_obama	concept:agentcollaborateswithagent	concept_politicianus_ronald_reagan
concept_sportsgame_championship	concept:sportsgameteam	concept_sportsteam_phillies
concept_sportsteam_carolina_panthers	concept:teamwontrophy	concept_awardtrophytournament_super_bowl
concept_stateorprovince_states	concept:statelocatedingeopoliticallocation	concept_country_cuba
concept_musicalbum_press	concept:atdate	concept_date_n2003
concept_sportsteam_cavs	concept:teamplaysagainstteam	concept_sportsteam_boston_celtics
concept_country_tunisia	concept:atdate	concept_dateliteral_n2007
concept_insect_mites	concept:animalsuchasinsect	concept_insect_pests
concept_sportsteam_titans	concept:teamplaysagainstteam	concept_sportsteam_houston_texans
concept_stateorprovince_states	concept:statelocatedingeopoliticallocation	concept_city_sweden
concept_profession_health	concept:professionistypeofprofession	concept_profession_faculty
concept_country_rwanda	concept:countrylocatedingeopoliticallocation	concept_continent_africa
concept_sportsteam_cleveland_indians	concept:teamplaysagainstteam	concept_sportsteam_orioles
concept_sportsteam_knicks	concept:teamplaysagainstteam	concept_sportsteam_cavs
concept_beverage_coffee	concept:agriculturalproductcamefromcountry	concept_country_new_zealand
concept_sportsteam_bucs	concept:teamplaysagainstteam	concept_sportsteam_rams
concept_sportsteam_utah_jazz	concept:teamplaysagainstteam	concept_sportsteam_timberwolves
concept_geometricshape_property	concept:atdate	concept_dateliteral_n2008
concept_person_prince	concept:personhascitizenship	concept_country_france_france
concept_animal_herbivores	concept:animalpreyson	concept_agriculturalproduct_pigs
concept_geometricshape_course	concept:atdate	concept_dateliteral_n2007
concept_beverage_coffee	concept:agriculturalproductcamefromcountry	concept_country_ethiopia
concept_clothing_jeans	concept:clothingtogowithclothing	concept_visualizableobject_coat
concept_country_liberia	concept:countryalsoknownas	concept_country_republic
concept_city_capital	concept:atdate	concept_date_n2004
concept_agriculturalproduct_products	concept:agriculturalproductincludingagriculturalproduct	concept_food_egg
concept_city_sydney	concept:citylocatedincountry	concept_country_australia
concept_country_china	concept:countrylocatedingeopoliticallocation	concept_city_members
concept_food_oil	concept:agriculturalproductincludingagriculturalproduct	concept_vegetable_corn
concept_clothing_jeans	concept:clothingtogowithclothing	concept_clothing_blouse
concept_clothing_shoes	concept:clothingtogowithclothing	concept_clothing_dress
concept_book_stay	concept:atdate	concept_month_may
concept_city_washington_d_c	concept:atdate	concept_date_n1993
concept_mammal_pets	concept:animalistypeofanimal	concept_mammal_small_dogs
concept_sportsteam_georgia_tech	concept:teamplaysagainstteam	concept_sportsteam_notre_dame
concept_buildingfeature_american	concept:atlocation	concept_city_newark
concept_mammal_bears	concept:animalistypeofanimal	concept_mammal_mammals
concept_company_sony	concept:companyeconomicsector	concept_politicsissue_entertainment
concept_weapon_weapons	concept:weaponmadeincountry	concept_country_republic_of_india
concept_country___america	concept:countryalsoknownas	concept_country_u_s_
concept_agriculturalproduct_pigs	concept:animalpreyson	concept_mammal_mammals
concept_lake_new	concept:mutualproxyfor	concept_country_usa
concept_mammal_small_animals	concept:animalpreyson	concept_mammal_guinea_pigs
concept_sportsteam_wildcats	concept:teamplaysagainstteam	concept_sportsteam_bears_29_17
concept_insect_insects	concept:arthropodandotherarthropod	concept_insect_honeybees
concept_sportsteam_golden_state_warriors	concept:teamplaysagainstteam	concept_sportsteam_utah_jazz
concept_sportsteam_falcons	concept:teamplaysagainstteam	concept_sportsteam_bears_29_17
concept_sportsteam_oakland_raiders	concept:teamplaysagainstteam	concept_sportsteam_packers
concept_sportsteam_jacksonville_jaguars	concept:teamplaysagainstteam	concept_sportsteam_bears_29_17
concept_book_amsterdam	concept:proxyfor	concept_eventoutcome_new
concept_website_washington_times	concept:companyeconomicsector	concept_academicfield_media
concept_athlete_j_p__ricciardi	concept:personalsoknownas	concept_person_pj_hill
concept_invertebrate_slugs	concept:animalthatfeedoninsect	concept_insect_pests
concept_dateliteral_n2002	concept:proxyfor	concept_stateorprovince_iowa
concept_mammal_pets	concept:animalistypeofanimal	concept_animal_creatures
concept_comedian_day	concept:atdate	concept_year_n1981
concept_sport_golf	concept:sportschoolincountry	concept_country_australia
concept_city_title	concept:atdate	concept_year_n1988
concept_person_prince	concept:agentinvolvedwithitem	concept_musicinstrument_guitar
concept_clothing_dress_shirt	concept:clothingtogowithclothing	concept_clothing_pants
concept_bird_chickens	concept:animaleatvegetable	concept_vegetable_corn
concept_sportsteam_titans	concept:teamplaysagainstteam	concept_sportsteam_cleveland_browns
concept_bank_first_class_mail	concept:competeswith	concept_company_priority
concept_mammal_rats	concept:animalpreyson	concept_mammal_mammals
concept_animal_small_mammals	concept:animalistypeofanimal	concept_arthropod_prey
concept_stateorprovince_idaho	concept:stateorprovinceisborderedbystateorprovince	concept_stateorprovince_oregon
concept_stateorprovince_utah	concept:stateorprovinceisborderedbystateorprovince	concept_stateorprovince_nevada
concept_city_home	concept:atdate	concept_year_n1960
concept_sportsteam_tampa_bay_rays	concept:teamplaysagainstteam	concept_sportsteam_red_sox
concept_country_czech_republic	concept:atdate	concept_year_n1998
concept_writer_husband	concept:atdate	concept_date_n1993
concept_company_american_airlines	concept:hasofficeincity	concept_city_new_york
concept_sportsteam_rockets	concept:mutualproxyfor	concept_company_los_angeles
concept_weapon_arms	concept:weaponmadeincountry	concept_country_nepal
concept_clothing_t_shirt	concept:clothingtogowithclothing	concept_clothing_hat
concept_person_greg001	concept:persongraduatedschool	concept_university_college
concept_amphibian_families	concept:animaldevelopdisease	concept_disease_illnesses
concept_mammal_monkeys	concept:specializationof	concept_mammal_animals
concept_geopoliticallocation_ecuador	concept:countrylocatedingeopoliticallocation	concept_country_countries
concept_governmentorganization_regulations	concept:subpartoforganization	concept_country_us
concept_book_terms	concept:atdate	concept_dateliteral_n2008
concept_country_armenia	concept:atdate	concept_date_n2003
concept_sportsteam_steelers	concept:teamplaysagainstteam	concept_sportsteam_buffalo_bills
concept_company_national	concept:hasofficeincountry	concept_country_republic
concept_jobposition_meeting	concept:atdate	concept_date_n1979
concept_product_minister	concept:atdate	concept_dateliteral_n2008
concept_book_inception	concept:atdate	concept_year_n1995
concept_company_new_york	concept:competeswith	concept_publication_people_
concept_city_jerusalem	concept:proxyfor	concept_country_israel
concept_profession_accountants	concept:professionistypeofprofession	concept_profession_professions
concept_governmentorganization_department	concept:atdate	concept_year_n1991
concept_sportsgame_series	concept:sportsgameteam	concept_sportsteam_san_antonio
concept_website_tour	concept:atdate	concept_date_n1979
concept_person_charles001	concept:personbelongstoorganization	concept_politicalparty_college
concept_sportsteam_chicago_white_sox	concept:teamplaysagainstteam	concept_sportsteam_cleveland_indians
concept_mammal_dogs	concept:animalistypeofanimal	concept_animal_birds002
concept_mammal_predators	concept:animalpreyson	concept_vertebrate_skunks
concept_book_services	concept:atdate	concept_dateliteral_n2002
concept_clothing_dresses	concept:clothingtogowithclothing	concept_clothing_shoes
concept_musicsong_sunday	concept:atdate	concept_dateliteral_n2006
concept_stateorprovince_states	concept:statelocatedingeopoliticallocation	concept_geopoliticallocation_agencies
concept_clothing_belt	concept:clothingtogowithclothing	concept_clothing_jacket
concept_website_information	concept:atdate	concept_year_n1997
concept_clothing_vest	concept:clothingtogowithclothing	concept_clothing_blouse
concept_visualizablething_use	concept:atdate	concept_date_n2001
concept_country_orleans	concept:locationlocatedwithinlocation	concept_river_state
concept_governmentorganization_house	concept:agentcontrols	concept_programminglanguage_state
concept_visualizablething_use	concept:organizationhiredperson	concept_personmexico_ryan_whitney
concept_weapon_national	concept:atlocation	concept_city_uk
concept_profession_providers	concept:professionistypeofprofession	concept_profession_health
concept_sportsteam_minnesota_vikings	concept:teamplaysagainstteam	concept_sportsteam_detroit_lions
concept_politicianus_president_obama	concept:politicianusmemberofpoliticalgroup	concept_governmentorganization_house
concept_website_kenya	concept:atdate	concept_date_n2000
concept_sportsteam_bears_29_17	concept:teamplaysagainstteam	concept_sportsteam_kansas_city_chiefs
concept_visualizablething_residence	concept:atdate	concept_month_october
concept_city_sweden	concept:proxyfor	concept_politicaloffice_new
concept_city_athens	concept:citylocatedinstate	concept_stateorprovince_georgia
concept_musicalbum_review	concept:atdate	concept_date_n2003
concept_insect_mites	concept:animalthatfeedoninsect	concept_arthropod_arthropods
concept_politicianus_ronald_reagan	concept:atdate	concept_year_n1981
concept_country_russian_federation	concept:countryalsoknownas	concept_country_former_soviet_union
concept_country_left_parties	concept:agentparticipatedinevent	concept_crimeorcharge_crimes
concept_sportsteam_steelers	concept:synonymfor	concept_sportsteam_arizona_cardinals_27_23
concept_person_governor	concept:personborninlocation	concept_city_york
concept_city_home	concept:proxyfor	concept_room_south
concept_mammal_bears	concept:animalpreyson	concept_mammal_mammals
concept_newspaper_journal	concept:competeswith	concept_website_chicago_tribune
concept_musicalbum_suit	concept:atdate	concept_dateliteral_n2002
concept_newspaper_times	concept:hasofficeincity	concept_city_paris
concept_sportsteam_new_york_giants	concept:teamplaysagainstteam	concept_sportsteam_marlins
concept_agriculturalproduct_flowers	concept:agriculturalproductcamefromcountry	concept_country_vietnam
concept_clothing_shorts	concept:clothingtogowithclothing	concept_clothing_white_shirts
concept_artery_cord	concept:bodypartcontainsbodypart	concept_braintissue_spinal_cord
concept_stateorprovince_georgia	concept:mutualproxyfor	concept_city_albany
concept_sportsteam_eagles	concept:teamplaysagainstteam	concept_sportsteam_packers
concept_city_web	concept:atdate	concept_dateliteral_n2005
concept_country_israel	concept:atdate	concept_date_n2000
concept_city_army	concept:atdate	concept_dateliteral_n1987
concept_book_network	concept:atdate	concept_dateliteral_n2006
concept_sportsteam_tampa_bay_devil_rays	concept:teamplaysagainstteam	concept_sportsteam_orioles
concept_person_patrice_bergeron	concept:personhascitizenship	concept_country_russia
concept_automobilemaker_chrysler	concept:automobilemakercardealersinstateorprovince	concept_stateorprovince_illinois
concept_sportsteam_kansas_city_chiefs	concept:teamplaysagainstteam	concept_sportsteam_bills
concept_celebrity_lawsuit	concept:atdate	concept_dateliteral_n2002
concept_sportsteam_raptors	concept:teamplaysagainstteam	concept_sportsteam_pistons
concept_sportsteam_twins	concept:teamplaysagainstteam	concept_sportsteam_orioles
concept_geometricshape_course	concept:atdate	concept_dateliteral_n2008
concept_city_auckland	concept:proxyfor	concept_country_new_zealand
concept_mammal_tigers	concept:mammalsuchasmammal	concept_mammal_monkeys
concept_musicalbum_family	concept:atdate	concept_date_n1979
concept_drug_acid	concept:chemicalistypeofchemical	concept_chemical_sulfur
concept_agriculturalproduct_green_tea	concept:agriculturalproductcontainchemical	concept_chemical_compounds
concept_insect_insects	concept:invertebratefeedonfood	concept_plant_shrubs
concept_olympics_implementation	concept:atdate	concept_date_n1996
concept_company_services	concept:agentinvolvedwithitem	concept_buildingfeature_windows
concept_country_usa	concept:atdate	concept_date_n1999
concept_politicianus_george_w__bush	concept:politicianrepresentslocation	concept_stateorprovince_states
concept_bird_owls	concept:animalpreyson	concept_animal_birds002
concept_personus_party	concept:personbelongstoorganization	concept_governmentorganization_house
concept_politicalparty_parliament	concept:atdate	concept_year_n1991
concept_furniture_beds	concept:furniturefoundinroom	concept_visualizablething_master_suite
concept_charactertrait_world	concept:atdate	concept_date_n1999
concept_musicalbum_review	concept:atdate	concept_date_n2000
concept_stateorprovince_south_dakota	concept:statelocatedingeopoliticallocation	concept_country_usa
concept_academicfield_directors	concept:atdate	concept_dateliteral_n2002
concept_vertebrate_page	concept:specializationof	concept_reptile_snakes
concept_city_web	concept:atdate	concept_year_n1994
concept_book_america	concept:atdate	concept_date_n2003
concept_politician_president_george_w_	concept:atdate	concept_date_n2001
concept_city_contract	concept:subpartof	concept_weatherphenomenon_water
concept_city_united_kingdom	concept:atdate	concept_date_n2003
concept_city_article	concept:atdate	concept_year_n1992
concept_city_las_vegas	concept:cityliesonriver	concept_attraction_grand
concept_sportsgame_games	concept:sportsgameteam	concept_sportsteam_houston_astros
concept_profession_individuals	concept:professionistypeofprofession	concept_profession_experts
concept_person_grant001	concept:atdate	concept_dateliteral_n2007
concept_city_york	concept:locationlocatedwithinlocation	concept_country_us
concept_company_nbc	concept:hasofficeincity	concept_city_washington_d_c
concept_automobilemaker_toyota	concept:automobilemakerdealersincity	concept_city_seattle
concept_beverage_teas	concept:agriculturalproductcontainchemical	concept_chemical_sugar
concept_sportsteam_tampa	concept:teamplaysagainstteam	concept_sportsteam_orioles
concept_mammal_small_animals	concept:animalpreyson	concept_bird_chickens
concept_date_n1964	concept:proxyfor	concept_beverage_new
concept_clothing_hat	concept:clothingtogowithclothing	concept_clothing_vest
concept_person_david	concept:personmovedtostateorprovince	concept_stateorprovince_utah
concept_clothing_shirts	concept:clothingtogowithclothing	concept_clothing_shoes
concept_animal_mice001	concept:specializationof	concept_insect_pests
concept_sportsteam_florida_marlins	concept:teamplaysincity	concept_city_miami
concept_crustacean_shellfish	concept:arthropodcalledarthropod	concept_arthropod_mussels
concept_language_french	concept:languageofcountry	concept_country_morocco
concept_sportsteam_broncos	concept:teamplaysagainstteam	concept_sportsteam_texans
concept_visualartmovement_britain	concept:atdate	concept_dateliteral_n2008
concept_clothing_skirt	concept:clothingtogowithclothing	concept_clothing_blouse
concept_profession_health	concept:professionistypeofprofession	concept_profession_professionals
concept_automobilemaker_toyota	concept:automobilemakerdealersincountry	concept_country_australia
concept_governmentorganization_department	concept:mutualproxyfor	concept_researchproject_engineering
concept_city_florida	concept:subpartof	concept_country_usa
concept_coach_p_j__hill	concept:personalsoknownas	concept_athlete_j_p__losman
concept_profession_specialists	concept:professionistypeofprofession	concept_profession_trainers
concept_agriculturalproduct_olive_oil	concept:agriculturalproductcookedwithagriculturalproduct	concept_agriculturalproduct_herbs
concept_chemical_fuels	concept:chemicalistypeofchemical	concept_chemical_sulfur
concept_profession_practitioners	concept:professionistypeofprofession	concept_profession_nurses
concept_agriculturalproduct_cotton	concept:agriculturalproductgrowinginstateorprovince	concept_stateorprovince_arkansas
concept_musicartist_american	concept:agentactsinlocation	concept_visualizablescene_ny
concept_mammal_wild_animals	concept:animalsuchasinvertebrate	concept_arthropod_raccoons
concept_sportsteam_cavs	concept:teamplaysagainstteam	concept_sportsteam_bucks
concept_bathroomitem_toilet	concept:itemfoundinroom	concept_visualizablething_bathrooms
concept_profession_specialists	concept:professionistypeofprofession	concept_profession_professionals
concept_sportsteam_kansas_city_royals	concept:teamplaysagainstteam	concept_sportsteam_yankees
concept_agriculturalproduct_oysters	concept:arthropodcalledarthropod	concept_crustacean_shellfish
concept_book_inception	concept:atdate	concept_year_n1985
concept_sportsteam_bears_29_17	concept:teamplaysagainstteam	concept_sportsteam_dallas_cowboys
concept_visualizablething_appointment	concept:atdate	concept_year_n1986
concept_city_berlin	concept:cityliesonriver	concept_attraction_grand
concept_mammal_hogs	concept:animaleatvegetable	concept_vegetable_corn
concept_mammal_cats	concept:animalistypeofanimal	concept_mammal_mammals
concept_city_birmingham	concept:proxyfor	concept_stateorprovince_alabama
concept_person_david	concept:persongraduatedfromuniversity	concept_university_ohio_state
concept_city_contract	concept:atdate	concept_date_n2009
concept_musician_agencies	concept:agentcollaborateswithagent	concept_person_state
concept_chemical_lead	concept:chemicalistypeofchemical	concept_chemical_pollutants
concept_city_contract	concept:proxyfor	concept_politicaloffice_new
concept_sportsteam_seattle_mariners	concept:teamplaysinleague	concept_sportsleague_mlb
concept_person_patrice_bergeron	concept:persongraduatedschool	concept_university_state_university
concept_sportsteam_jaguars	concept:teamplaysagainstteam	concept_sportsteam_titans
concept_bank_general_electric	concept:agentcontrols	concept_retailstore_nbc
concept_sportsteam_dallas_cowboys	concept:teamplaysagainstteam	concept_sportsteam_packers
concept_programminglanguage_stroke	concept:atdate	concept_dateliteral_n2008
concept_governmentorganization_department	concept:atdate	concept_dateliteral_n2002
concept_sportsteam_kings_college	concept:agentparticipatedinevent	concept_convention_games
concept_sportsteam_pittsburgh_penguins	concept:teamplaysagainstteam	concept_sportsteam_new_york_islanders
concept_city_father	concept:atdate	concept_year_n1989
concept_mammal_pets	concept:animalpreyson	concept_mammal_ferrets
concept_buildingfeature_doors	concept:atdate	concept_dateliteral_n1990
concept_company_national	concept:hasofficeincountry	concept_country_ghana
concept_creditunion_kansas	concept:companyeconomicsector	concept_economicsector_insurance_coverage
concept_chemical_nitrogen	concept:chemicalistypeofchemical	concept_chemical_gas
concept_insect_grubs	concept:invertebratefeedonfood	concept_food_roots
concept_perceptionaction_first_meeting	concept:atdate	concept_year_n1992
concept_athlete_gary	concept:persongraduatedschool	concept_university_college
concept_chemical_carbon	concept:chemicalistypeofchemical	concept_chemical_products
concept_profession_engineers	concept:professionistypeofprofession	concept_profession_members
concept_insect_mites	concept:animalthatfeedoninsect	concept_insect_pests
concept_city_alaska	concept:subpartof	concept_country_usa
concept_mammal_pets	concept:animalpreyson	concept_mammal_rabbits
concept_weapon_arms	concept:weaponmadeincountry	concept_country_syria
concept_profession_professionals	concept:professionistypeofprofession	concept_profession_specialists
concept_artery_arteries	concept:arterycalledartery	concept_artery_cord
concept_politicianus_george_w__bush	concept:politicianusendorsedbypoliticianus	concept_politician_clinton
concept_politicianus_president_clinton	concept:politicianusholdsoffice	concept_politicaloffice_assistant_secretary
concept_website_decision	concept:atdate	concept_year_n1994
concept_book_new	concept:atdate	concept_dateliteral_n2008
concept_city_cairo	concept:citylocatedincountry	concept_country_egypt
concept_mammal_bear	concept:animalistypeofanimal	concept_mammal_predators
concept_county_san_francisco	concept:atdate	concept_dateliteral_n2007
concept_person_bill	concept:persongraduatedfromuniversity	concept_university_college
concept_profession_providers	concept:professionistypeofprofession	concept_jobposition_nurse
concept_newspaper_journal	concept:competeswith	concept_company_fox
concept_governmentorganization_investigation	concept:atdate	concept_date_n1993
concept_governmentorganization_cabinet	concept:atdate	concept_dateliteral_n2002
concept_person_andrew001	concept:agentcontrols	concept_charactertrait_world
concept_food_eggs	concept:agriculturalproductcomingfromvertebrate	concept_animal_birds002
concept_meat_breast	concept:fooddecreasestheriskofdisease	concept_disease_illnesses
concept_musicsong_oklahoma	concept:proxyfor	concept_weatherphenomenon_new
concept_politicalparty_senate	concept:agentcollaborateswithagent	concept_biotechcompany_white
concept_jobposition_meeting	concept:atdate	concept_year_n1992
concept_buildingfeature_american	concept:atlocation	concept_city_york
concept_city_houston	concept:atdate	concept_dateliteral_n2007
concept_city_washington_d_c	concept:cityliesonriver	concept_attraction_grand
concept_insect_insects	concept:animalsuchasinsect	concept_insect_moth
concept_jobposition_court	concept:atdate	concept_year_n1992
concept_company_new_york	concept:competeswith	concept_newspaper_philadelphia_inquirer
concept_university_administration	concept:atdate	concept_dateliteral_n2006
concept_animal_carnivores	concept:animalsuchasfish	concept_fish_sharks
concept_city_london_city	concept:atdate	concept_dateliteral_n2007
concept_city_denver	concept:proxyfor	concept_lake_new
concept_person_prince	concept:personhascitizenship	concept_country_hungary
concept_mammal_mammals	concept:animalpreyson	concept_mammal_tigers
concept_sportsgame_series	concept:sportsgameteam	concept_sportsteam_new_york_giants
concept_politicsissue_public	concept:atdate	concept_year_n1970
concept_profession_nurses	concept:professionistypeofprofession	concept_profession_clinicians
concept_company_new_york	concept:mutualproxyfor	concept_beverage_new
concept_musicalbum_foundation	concept:atdate	concept_dateliteral_n2002
concept_language_arabic	concept:languageofcountry	concept_country_jordan
concept_politician_clinton	concept:politicianusendorsedbypoliticianus	concept_politicianus_joe_biden
concept_language_german	concept:languageofuniversity	concept_university_ohio_state
concept_sport_golf	concept:sportschoolincountry	concept_country_bulgaria
concept_sportsteam_blackhawks	concept:agentparticipatedinevent	concept_convention_games
concept_sportsteam_oakland_raiders	concept:teamplaysagainstteam	concept_sportsteam_florida_international
concept_city_team	concept:agentcollaborateswithagent	concept_politician_jobs
concept_animal_students	concept:animaldevelopdisease	concept_disease_aids
concept_person_james001	concept:personhascitizenship	concept_country_england
concept_mammal_sheep	concept:mammalsuchasmammal	concept_mammal_mountain_lions
concept_buildingfeature_systems	concept:subpartof	concept_visualizableattribute_drinking_water
concept_city_ottawa	concept:atdate	concept_dateliteral_n2008
concept_sportsteam_broncos	concept:teamplaysagainstteam	concept_sportsteam_rams
concept_academicfield_trial	concept:atdate	concept_year_n1991
concept_sportsteam_usc	concept:teamplaysagainstteam	concept_sportsteam_bears_29_17
concept_city_phnom_penh	concept:locationlocatedwithinlocation	concept_country_cambodia
concept_politician_president_george_w_	concept:personhasresidenceingeopoliticallocation	concept_stateorprovince_texas
concept_website_performance	concept:atdate	concept_dateliteral_n2005
concept_agriculturalproduct_green_tea	concept:fooddecreasestheriskofdisease	concept_disease_heart_disease
concept_city_new_york	concept:agentparticipatedinevent	concept_eventoutcome_result
concept_person_prince	concept:personhascitizenship	concept_country_germany
concept_county_new_mexico	concept:proxyfor	concept_coach_new
concept_city_area	concept:mutualproxyfor	concept_beverage_new
concept_politician_reagan	concept:politicianrepresentslocation	concept_country_u_s_
concept_city_service	concept:atdate	concept_date_n1976
concept_profession_nurses	concept:professionistypeofprofession	concept_profession_technicians
concept_island_operations	concept:atdate	concept_dateliteral_n2006
concept_profession_experts	concept:professionistypeofprofession	concept_profession_leaders
concept_sportsteam_los_angeles_clippers	concept:teamplaysinleague	concept_sportsleague_nba
concept_sportsteam_red_sox	concept:teamplaysagainstteam	concept_sportsteam_yankees
concept_city_dallas	concept:proxyfor	concept_stateorprovince_texas
concept_agriculturalproduct_pigs	concept:agentcompeteswithagent	concept_animal_herbivores
concept_city_singapore	concept:atdate	concept_dateliteral_n2002
concept_bank_royal	concept:hasofficeincountry	concept_country_new_zealand
concept_country_romania	concept:countrylocatedingeopoliticallocation	concept_country_countries
concept_city_washington_d_c	concept:atdate	concept_date_n2004
concept_city_phnom_penh	concept:atdate	concept_date_n2004
concept_county_bedford	concept:atlocation	concept_beach_massachusetts
concept_insect_grubs	concept:arthropodcalledarthropod	concept_insect_insects
concept_sportsgame_championship	concept:sportsgameteam	concept_sportsteam_huskies
concept_reptile_cat	concept:animalistypeofanimal	concept_animal_animals002
concept_clothing_blue_jeans	concept:clothingtogowithclothing	concept_clothing_hat
concept_visualizablething_residence	concept:atdate	concept_month_january
concept_country_republic	concept:countryalsoknownas	concept_country_britain
concept_sportsteam_cleveland_indians_organization	concept:teamplaysagainstteam	concept_sportsteam_chicago_white_sox
concept_room_south	concept:mutualproxyfor	concept_person_mugabe
concept_city_home	concept:atdate	concept_year_n1978
concept_language_arabic	concept:languageofcountry	concept_country_sudan
concept_mammal_rabbits	concept:animalistypeofanimal	concept_animal_herbivores
concept_arthropod_clams	concept:arthropodcalledarthropod	concept_crustacean_shellfish
concept_agriculturalproduct_salt	concept:agriculturalproductcookedwithagriculturalproduct	concept_agriculturalproduct_olive_oil
concept_geopoliticalorganization_e_mail	concept:agentcreated	concept_website_information
concept_country_belarus	concept:locationlocatedwithinlocation	concept_landscapefeatures_states
concept_artery_brain	concept:subpartof	concept_website_blood
concept_sportsteam_bruins	concept:teamplaysagainstteam	concept_sportsteam_florida_international
concept_sportsteam_arizona_diamond_backs	concept:teamplaysagainstteam	concept_sportsteam_st___louis_cardinals
concept_company_japan	concept:atdate	concept_year_n1991
concept_room_offices	concept:atdate	concept_dateliteral_n2002
concept_website_introduction	concept:atdate	concept_dateliteral_n2007
concept_chemical_gas	concept:chemicalistypeofchemical	concept_chemical_methane
concept_city_sydney	concept:proxyfor	concept_country_australia
concept_governmentorganization_department	concept:atdate	concept_dateliteral_n2007
concept_chemical_organic_compounds	concept:chemicalistypeofchemical	concept_chemical_pollutants
concept_sportsteam_pittsburgh_pirates	concept:agentparticipatedinevent	concept_convention_games
concept_sportsteam_steelers	concept:teamplaysagainstteam	concept_sportsteam_titans
concept_chemical_mercury	concept:chemicalistypeofchemical	concept_chemical_water
concept_year_new	concept:mutualproxyfor	concept_city_name
concept_clothing_hats	concept:clothingtogowithclothing	concept_clothing_dresses
concept_country_cuba	concept:countrylocatedingeopoliticallocation	concept_country_countries
concept_profession_health	concept:professionistypeofprofession	concept_profession_professions
concept_politicsissue_public	concept:atdate	concept_year_n1988
concept_politicsissue_public	concept:atdate	concept_dateliteral_n1990
concept_country_united_states	concept:agentcompeteswithagent	concept_tradeunion_article
concept_language_english	concept:languageofcountry	concept_country_egypt
concept_sportsteam_st___louis_cardinals	concept:teamplaysagainstteam	concept_sportsteam_royals
concept_agriculturalproduct_flowers	concept:agriculturalproductcamefromcountry	concept_country_poland
concept_stateorprovince_illinois	concept:mutualproxyfor	concept_city_bloomington
concept_artery_fluid	concept:bodypartcontainsbodypart	concept_nerve_nervous_system
concept_city_home	concept:subpartoforganization	concept_terroristorganization_state
concept_city_communities	concept:istallerthan	concept_publication_people_
concept_island_operations	concept:atdate	concept_year_n1975
concept_island_operations	concept:atdate	concept_date_n2009
concept_airport_europe	concept:atdate	concept_date_n1993
concept_country_ethiopia	concept:countrylocatedingeopoliticallocation	concept_stateorprovince_states
concept_city_shanghai	concept:atdate	concept_dateliteral_n2002
concept_city_johannesburg	concept:atdate	concept_dateliteral_n2007
concept_mammal_predators	concept:animalistypeofanimal	concept_mammal_mountain_lions
concept_sportsteam_liverpool_john_moores_university	concept:teamplaysagainstteam	concept_sportsteam_man_utd
concept_monarch_property	concept:agentcollaborateswithagent	concept_person_state
concept_country_sudan	concept:atdate	concept_dateliteral_n2002
concept_musicalbum_review	concept:atdate	concept_year_n1997
concept_agriculturalproduct_pigs	concept:animalpreyson	concept_mammal_small_animals
concept_emotion_appeal	concept:atdate	concept_dateliteral_n2005
concept_bathroomitem_bath_tub	concept:itemfoundinroom	concept_officebuildingroom_en_suite_bathroom
concept_company_goldman_sachs001	concept:companyeconomicsector	concept_economicsector_investment
concept_country_republic	concept:countryalsoknownas	concept_country_thailand
concept_sport_golf	concept:sportschoolincountry	concept_country_us
concept_publication_espn	concept:headquarteredin	concept_city_new_york
concept_male_russia	concept:subpartof	concept_vehicle_countries
concept_governmentorganization_house	concept:atdate	concept_dateliteral_n1980
concept_animal_birds002	concept:agentparticipatedinevent	concept_eventoutcome_result
concept_country_arabia_saudita	concept:countrylocatedingeopoliticallocation	concept_country_middle
concept_city_home	concept:atdate	concept_date_n2004
concept_charactertrait_opening	concept:atdate	concept_year_n1991
concept_male_russia	concept:atdate	concept_dateliteral_n1945
concept_country_turkey	concept:atdate	concept_dateliteral_n2002
concept_county_columbus	concept:atlocation	concept_stateorprovince_indiana
concept_mammal_horses	concept:animalistypeofanimal	concept_mammal_farm_animals
concept_city_newark	concept:locationlocatedwithinlocation	concept_stateorprovince_new_jersey
concept_male_world	concept:agentcollaborateswithagent	concept_person_michael002
concept_sportsteam_carolina	concept:organizationheadquarteredinstateorprovince	concept_stateorprovince_florida
concept_city_centre	concept:thinghasshape	concept_geometricshape_triangle
concept_lake_new	concept:mutualproxyfor	concept_month_november
concept_invertebrate_cattle	concept:agentcompeteswithagent	concept_agriculturalproduct_livestock
concept_emotion_appeal	concept:atdate	concept_year_n1995
concept_sportsgame_championship	concept:sportsgameteam	concept_sportsteam_sixers
concept_stateorprovince_states	concept:statelocatedingeopoliticallocation	concept_country_armenia
concept_city_decatur	concept:proxyfor	concept_stateorprovince_georgia
concept_sportsteam_stanford	concept:teamplaysagainstteam	concept_sportsteam_anaheim_ducks
concept_profession_instructors	concept:professionistypeofprofession	concept_profession_artists
concept_company_apple	concept:organizationterminatedperson	concept_politician_jobs
concept_politicianus_bill_clinton	concept:politicianusmemberofpoliticalgroup	concept_governmentorganization_house
concept_geopoliticalorganization_northern	concept:atlocation	concept_continent_africa
concept_jobposition_meeting	concept:atdate	concept_year_n1981
concept_mammal_cows	concept:animalistypeofanimal	concept_mammal_domestic_animals
concept_furniture_sleeper_sofa	concept:furniturefoundinroom	concept_room_suite
concept_athlete_j_p__losman	concept:personalsoknownas	concept_coach_p_j__carlesimo
concept_chemical_carbon	concept:chemicalistypeofchemical	concept_chemical_chemicals
concept_buildingfeature_american	concept:atlocation	concept_city_grand_rapids_kalamazoo_battle_creek
concept_city_mexico_city	concept:istallerthan	concept_publication_people_
concept_weapon_weapons	concept:weaponmadeincountry	concept_country_belarus
concept_sport_hockey	concept:sportusesstadium	concept_stadiumoreventvenue_td_garden
concept_sportsteam_nuggets	concept:agentparticipatedinevent	concept_convention_games
concept_clothing_hats	concept:clothingtogowithclothing	concept_clothing_jeans
concept_nongovorganization_forces	concept:atdate	concept_date_n2003
concept_island_operations	concept:atdate	concept_year_n1986
concept_vehicle_countries	concept:atdate	concept_dateliteral_n2002
concept_sportsgame_title	concept:sportsgameteam	concept_sportsteam_red_sox
concept_male_history	concept:agentcompeteswithagent	concept_tradeunion_article
concept_country_germany	concept:countrylocatedingeopoliticallocation	concept_geopoliticallocation_destinations
concept_agriculturalproduct_livestock	concept:animalistypeofanimal	concept_mammal_pets
concept_book_morning	concept:atdate	concept_dateliteral_n2002
concept_profession_instructors	concept:professionistypeofprofession	concept_profession_consultants
concept_country_qatar	concept:atdate	concept_dateliteral_n2008
concept_island_post	concept:atlocation	concept_county_los_angeles_county
concept_city_orleans	concept:citylocatedingeopoliticallocation	concept_stateorprovince_louisiana
concept_politicalparty_parliament	concept:atdate	concept_dateliteral_n2002
concept_sportsteam_heat	concept:teamplaysagainstteam	concept_sportsteam_rockets
concept_mammal_small_animals	concept:animalpreyson	concept_animal_hamsters
concept_language_english	concept:languageofcountry	concept_country_australia
concept_animal_animals001	concept:animalpreyson	concept_animal_mammals001
concept_athlete_playoff	concept:atdate	concept_date_n2004
concept_person_lord	concept:atdate	concept_dateliteral_n2007
concept_furniture_bed	concept:furniturefoundinroom	concept_visualizablething_master_bedroom
concept_country_scandinavian_countries	concept:countryalsoknownas	concept_country_china
concept_sportsgame_finals	concept:sportsgameteam	concept_sportsteam_cavs
concept_governmentorganization_management	concept:atdate	concept_dateliteral_n2008
concept_insect_insects	concept:animalthatfeedoninsect	concept_insect_mealy_bugs
concept_sportsteam_rockets	concept:teamplaysagainstteam	concept_sportsteam_mavericks
concept_clothing_black_pants	concept:clothingtogowithclothing	concept_clothing_boots
concept_stateorprovince_massachusetts	concept:stateorprovinceisborderedbystateorprovince	concept_stateorprovince_new_hampshire
concept_jobposition_physician	concept:professionistypeofprofession	concept_profession_workers
concept_clothing_shoes	concept:clothingtogowithclothing	concept_clothing_dresses
concept_automobilemaker_chrysler	concept:automobilemakercardealersinstateorprovince	concept_stateorprovince_michigan
concept_beverage_new	concept:atlocation	concept_website_issue
concept_agriculturalproduct_livestock	concept:agriculturalproductincludingagriculturalproduct	concept_mammal_horses
concept_arthropod_arthropods	concept:animalthatfeedoninsect	concept_insect_mites
concept_person_john003	concept:hassibling	concept_person_james001
concept_governmentorganization_legislation	concept:atdate	concept_date_n2001
concept_agriculturalproduct_plants	concept:thinghascolor	concept_color_yellow
concept_country_mexico	concept:countryalsoknownas	concept_country_republic
concept_musicsong_night	concept:atdate	concept_year_n1991
concept_terroristorganization_force	concept:atdate	concept_year_n1992
concept_bathroomitem_bath_tub	concept:itemfoundinroom	concept_visualizablething_bathrooms
concept_weapon_weapons	concept:weaponmadeincountry	concept_country_south_africa
concept_clothing_slacks	concept:clothingtogowithclothing	concept_clothing_blouse
concept_animal_humans	concept:animalpreyson	concept_mammal_pets
concept_sportsteam_cleveland_indians_organization	concept:teamplaysagainstteam	concept_sportsteam_orioles
concept_language_spanish	concept:languageofuniversity	concept_university_ohio_state
concept_city_madrid	concept:citylocatedincountry	concept_country_spain
concept_city_service	concept:atdate	concept_year_n1956
concept_blog_form	concept:agentcreated	concept_city_design
concept_city_york	concept:atlocation	concept_skiarea_maine
concept_city_parents	concept:agentparticipatedinevent	concept_eventoutcome_result
concept_company_los_angeles	concept:mutualproxyfor	concept_sportsteam_golden_state_warriors
concept_jobposition_executive_director	concept:atdate	concept_date_n2001
concept_arthropod_crustaceans	concept:arthropodcalledarthropod	concept_crustacean_crab
concept_mammal_pets	concept:animalistypeofanimal	concept_agriculturalproduct_livestock
concept_agriculturalproduct_crops	concept:agriculturalproductincludingagriculturalproduct	concept_agriculturalproduct_grains
concept_country_kuwait	concept:countrylocatedingeopoliticallocation	concept_country_region
concept_musicalbum_press	concept:atdate	concept_date_n2009
concept_company_post	concept:competeswith	concept_newspaper_daily
concept_sportsteam_new_york_giants	concept:teamplaysagainstteam	concept_sportsteam_white_sox
concept_clothing_skirt	concept:clothingtogowithclothing	concept_clothing_pants
concept_sportsteam_cavs	concept:teamplaysagainstteam	concept_sportsteam_memphis_grizzlies
concept_country_west_indies	concept:atdate	concept_dateliteral_n2002
concept_mediatype_books	concept:atdate	concept_dateliteral_n1990
concept_river_arts	concept:atdate	concept_dateliteral_n2008
concept_city_service	concept:agentcontrols	concept_museum_steve
concept_geometricshape_effect	concept:atdate	concept_year_n1981
concept_chemical_sulfur	concept:chemicalistypeofchemical	concept_chemical_particles
concept_politicalparty_republic	concept:synonymfor	concept_city_sweden
concept_stateorprovince_alabama	concept:statelocatedingeopoliticallocation	concept_country_united_states
concept_mammal_rodents	concept:animalistypeofanimal	concept_mammal_small_pets
concept_country_israel	concept:atdate	concept_dateliteral_n2006
concept_sportsteam_florida_marlins	concept:atlocation	concept_county_miami
concept_city_berlin	concept:atdate	concept_dateliteral_n2005
concept_director_committee	concept:atdate	concept_dateliteral_n2006
concept_publication_people_	concept:hasofficeincountry	concept_country_china
concept_sport_golf	concept:sportfansincountry	concept_country_cyprus
concept_island_interview	concept:atdate	concept_dateliteral_n2008
concept_country___america	concept:countryalsoknownas	concept_country_palestine
concept_country_czech_republic	concept:atdate	concept_date_n2000
concept_mammal_mammals	concept:animalistypeofanimal	concept_mammal_guinea_pigs
concept_mammal_dog	concept:animalpreyson	concept_animal_pet
concept_city_berlin	concept:atdate	concept_date_n1996
concept_politicianus_romney	concept:politicianusendorsedbypoliticianus	concept_politicianus_barack_obama
concept_governmentorganization_commission	concept:mutualproxyfor	concept_sportsequipment_board
concept_buildingfeature_doors	concept:atdate	concept_date_n2004
concept_person_michael002	concept:personmovedtostateorprovince	concept_stateorprovince_california
concept_country_netherlands	concept:atdate	concept_dateliteral_n2007
concept_animal_carnivores	concept:animalistypeofanimal	concept_mammal_wolves
concept_comedian_day	concept:atdate	concept_dateliteral_n2008
concept_geopoliticalorganization_schedule	concept:atdate	concept_dateliteral_n2005
concept_animal_large_animals	concept:animalistypeofanimal	concept_mammal_dogs
concept_musicalbum_system	concept:atdate	concept_year_n1992
concept_profession_coaches	concept:professionistypeofprofession	concept_profession_staff
concept_company_apple002	concept:competeswith	concept_website_facebook
concept_country_kosovo	concept:countryalsoknownas	concept_country_republic
concept_clothing_black_shirt	concept:clothingtogowithclothing	concept_clothing_tie
concept_profession_instructors	concept:professionistypeofprofession	concept_profession_experts
concept_bank_national	concept:bankbankincountry	concept_country_libya
concept_university_ministry	concept:proxyfor	concept_beverage_new
concept_vegetable_pepper	concept:agriculturalproductcookedwithagriculturalproduct	concept_vegetable_peas
concept_stateorprovince_utah	concept:statelocatedingeopoliticallocation	concept_country_u_s_
concept_person_prince	concept:personhasjobposition	concept_jobposition_lord
concept_charactertrait_world	concept:atdate	concept_dateliteral_n2006
concept_musicalbum_death	concept:atdate	concept_year_n1981
concept_automobilemaker_cadillac	concept:automobilemakerdealersincity	concept_city_austin
concept_sportsteam_dodgers	concept:teamplaysagainstteam	concept_sportsteam_st___louis_cardinals
concept_city_new_york	concept:agentactsinlocation	concept_lake_new
concept_musicartist_times	concept:agentactsinlocation	concept_visualizablescene_ny
concept_biotechcompany_apple	concept:organizationterminatedperson	concept_politician_jobs
concept_stateorprovince_states	concept:statelocatedingeopoliticallocation	concept_country_republic
concept_country_afghanistan	concept:atdate	concept_dateliteral_n2008
concept_sportsteam_colorado_rockies	concept:teamplaysagainstteam	concept_sportsteam_new_york_giants
concept_country_israel	concept:atdate	concept_year_n1948
concept_mammal_canines	concept:animalistypeofanimal	concept_mammal_animals
concept_person_paul001	concept:personhasjobposition	concept_jobposition_king
concept_country_morocco	concept:atdate	concept_date_n2001
concept_company_national	concept:agentactsinlocation	concept_city_united_kingdom
concept_politician_jobs	concept:personbelongstoorganization	concept_sportsteam_state_university
concept_sportsteam_new_york_giants	concept:teamplaysagainstteam	concept_sportsteam_chowan_braves
concept_sportsteam_mariners	concept:teamplaysagainstteam	concept_sportsteam_chicago_white_sox
concept_chemical_chlorine	concept:chemicalistypeofchemical	concept_chemical_chemicals
concept_sportsteam_bears_29_17	concept:teamplaysagainstteam	concept_sportsteam_usc
concept_sportsteam_pittsburgh_penguins	concept:teamplayssport	concept_sport_hockey
concept_city_york	concept:cityliesonriver	concept_river_niagara
concept_mammal_exotic_animals	concept:animalpreyson	concept_mammal_pets
concept_country_el_salvador	concept:atdate	concept_dateliteral_n2008
concept_governmentorganization_rule	concept:atdate	concept_dateliteral_n2008
concept_animal_mice001	concept:animaldevelopdisease	concept_disease_cancer
concept_mediatype_books	concept:atdate	concept_dateliteral_n2010
concept_county_detroit	concept:proxyfor	concept_coach_new
concept_sport_rugby	concept:sportschoolincountry	concept_country_england
concept_sportsteam_bucs	concept:teamplaysagainstteam	concept_sportsteam_sd_chargers
concept_musicalbum_suit	concept:atdate	concept_dateliteral_n2007
concept_stateorprovince_states	concept:statelocatedingeopoliticallocation	concept_visualizablething_use
concept_language_french	concept:languageofcountry	concept_country_new_zealand
concept_sportsteam_red_sox	concept:teamplaysagainstteam	concept_sportsteam_philadelphia_phillies
concept_chemical_companies	concept:atdate	concept_dateliteral_n2008
concept_profession_physicians	concept:professionistypeofprofession	concept_profession_researchers
concept_geopoliticallocation_show	concept:atdate	concept_year_n1989
concept_person_david	concept:persongraduatedfromuniversity	concept_university_law_school
concept_emotion_series	concept:atdate	concept_dateliteral_n2008
concept_visualizablething_residence	concept:atdate	concept_month_july
concept_city_st_louis	concept:citylocatedingeopoliticallocation	concept_geopoliticallocation_national
concept_company_new_york	concept:agentcompeteswithagent	concept_musicartist_journal
concept_politicianus_bush	concept:politicianusendorsedbypoliticianus	concept_politicianus_president_george_w__bush
concept_politicianus_bill	concept:politicianusendorsedbypoliticianus	concept_politicianus_gore
concept_chemical_lead	concept:chemicalistypeofchemical	concept_chemical_minerals
concept_sportsteam_texas_rangers	concept:teamplaysagainstteam	concept_sportsteam_mariners
concept_bathroomitem_shower	concept:itemfoundinroom	concept_visualizablething_bathrooms
concept_year_new	concept:mutualproxyfor	concept_city_hawaii
concept_transportation_operation	concept:atdate	concept_dateliteral_n2008
concept_country_republic	concept:countryalsoknownas	concept_country_taiwan
concept_agriculturalproduct_livestock	concept:animalpreyson	concept_animal_poultry
concept_sportsteam_florida_international	concept:teamplaysagainstteam	concept_sportsteam_saints
concept_profession_nurses	concept:professionistypeofprofession	concept_profession_educators
concept_county_records	concept:organizationhiredperson	concept_personmexico_ryan_whitney
concept_country_republic	concept:countryalsoknownas	concept_country_venezuela
concept_mediatype_books	concept:atdate	concept_dateliteral_n1980
concept_sportsteam_pirates	concept:teamplaysagainstteam	concept_sportsteam_st___louis_cardinals
concept_sportsteam_red_sox	concept:teamplaysagainstteam	concept_sportsteam_new_york_mets
concept_country_poland	concept:atdate	concept_date_n2009
concept_chemical_production	concept:chemicalistypeofchemical	concept_chemical_gas
concept_buildingfeature_american	concept:atlocation	concept_city_washington_d_c
concept_person_sri_lanka	concept:atdate	concept_dateliteral_n2006
concept_country_former_soviet_union	concept:atdate	concept_year_n1991
concept_city_washington_d_c	concept:agentcompeteswithagent	concept_stateorprovince_times
concept_country_finland	concept:countrylocatedingeopoliticallocation	concept_geopoliticallocation_destinations
concept_musicsong_sale	concept:atdate	concept_year_n1995
concept_sportsgame_playoffs	concept:sportsgameteam	concept_sportsteam_sd_chargers
concept_geometricshape_effect	concept:atdate	concept_dateliteral_n2007
concept_geopoliticallocation_agencies	concept:atdate	concept_date_n2001
concept_island_operations	concept:proxyfor	concept_book_new
concept_buildingfeature_doors	concept:atdate	concept_year_n1997
concept_automobilemaker_dodge	concept:automobilemakerdealersincity	concept_city_milwaukee
concept_book_stay	concept:atdate	concept_date_n2001
concept_sportsteam_broncos	concept:teamhomestadium	concept_stadiumoreventvenue_invesco_field
concept_bank_national	concept:bankbankincountry	concept_country_zambia
concept_sportsgame_playoffs	concept:sportsgameteam	concept_sportsteam_new_jersey_nets
concept_county_miami	concept:locationlocatedwithinlocation	concept_city_florida
concept_city_washington_d_c	concept:agentcompeteswithagent	concept_musicartist_journal
concept_terroristorganization_force	concept:atdate	concept_dateliteral_n2002
concept_person_chris	concept:agentcontrols	concept_charactertrait_world
concept_language_spanish	concept:languageofcountry	concept_country_argentina
concept_charactertrait_world	concept:atdate	concept_year_n1994
concept_website_visit	concept:atdate	concept_dateliteral_n2002
concept_profession_practitioners	concept:professionistypeofprofession	concept_profession_dentists
concept_country_israel	concept:atdate	concept_year_n1995
concept_reptile_pets	concept:animalistypeofanimal	concept_animal_mice001
concept_company_general	concept:hasofficeincountry	concept_country_us
concept_emotion_band	concept:atdate	concept_year_n1992
concept_mammal_small_animals	concept:animalpreyson	concept_reptile_lizards
concept_agriculturalproduct_plants	concept:agriculturalproducttoattractinsect	concept_insect_mites
concept_bodypart_tissue001	concept:bodypartcontainsbodypart	concept_braintissue_spinal_cord
concept_athlete_j_p__arencibia	concept:coachwontrophy	concept_awardtrophytournament_super_bowl_xlii
concept_director_committee	concept:agentactsinlocation	concept_country_united_states
concept_mammal_horses	concept:animalistypeofanimal	concept_mammal_animals
concept_politicianus_hillary_clinton	concept:agentbelongstoorganization	concept_politicalparty_house
concept_city_home	concept:atdate	concept_dateliteral_n2010
concept_vegetable_potatoes	concept:agriculturalproductcookedwithagriculturalproduct	concept_vegetable_spinach
concept_academicfield_information_technology	concept:academicfieldsuchasacademicfield	concept_academicfield_computer_science
concept_jobposition_court	concept:atdate	concept_dateliteral_n2008
concept_city_title	concept:atdate	concept_date_n2004
concept_geopoliticallocation_agencies	concept:atdate	concept_year_n1998
concept_vehicle_countries	concept:atdate	concept_dateliteral_n2008
concept_sportsteam_steelers	concept:teamplaysagainstteam	concept_sportsteam_carolina_panthers
concept_visualizableobject_coat	concept:clothingtogowithclothing	concept_clothing_jeans
concept_company_post	concept:organizationheadquarteredincity	concept_county_los_angeles_county
concept_sportsteam_suns	concept:teamplaysagainstteam	concept_sportsteam_cavs
concept_musicalbum_order	concept:atdate	concept_year_n1991
concept_profession_scientists	concept:professionistypeofprofession	concept_profession_staff
concept_musicartist_american	concept:agentactsinlocation	concept_city_hartford
concept_academicfield_association	concept:atdate	concept_dateliteral_n2008
concept_emotion_senate	concept:atdate	concept_year_n1991
concept_amphibian_families	concept:animaldevelopdisease	concept_disease_disabilities
concept_city_manila	concept:locationlocatedwithinlocation	concept_country_philippines
concept_sportsteam_montreal_canadiens	concept:teamplaysagainstteam	concept_sportsteam_florida_international
concept_personmexico_ryan_whitney	concept:worksfor	concept_city_washington_d_c
concept_person_david	concept:personmovedtostateorprovince	concept_stateorprovince_california
concept_language_arabic	concept:languageofcountry	concept_country_somalia
concept_terroristorganization_state	concept:agentparticipatedinevent	concept_crimeorcharge_crimes
concept_bank_priority_mail	concept:competeswith	concept_bank_dhl
concept_politicalparty_house	concept:organizationhiredperson	concept_person_republican
concept_sportsteam_eagles	concept:teamplaysagainstteam	concept_sportsteam_seahawks
concept_geopoliticallocation_surgery	concept:atdate	concept_date_n2009
concept_politicianus_president_bush	concept:politicianusmemberofpoliticalgroup	concept_governmentorganization_house
concept_mediatype_books	concept:atdate	concept_dateliteral_n1987
concept_sportsteam_buffalo_bills	concept:teamplaysagainstteam	concept_sportsteam_cleveland_browns
concept_sport_ski	concept:sportschoolincountry	concept_country_u_s_
concept_sportsteam_stanford	concept:teamplaysincity	concept_city_new_york
concept_automobilemaker_dodge	concept:automobilemakercardealersinstateorprovince	concept_stateorprovince_michigan
concept_politicaloffice_office	concept:mutualproxyfor	concept_sportsequipment_board
concept_city_newark	concept:atlocation	concept_stateorprovince_california
concept_city_capital	concept:proxyfor	concept_politicaloffice_new
concept_academicfield_physics	concept:academicfieldconcernssubject	concept_nongovorganization_forces
concept_country_republic_of_india	concept:organizationterminatedperson	concept_scientist_no_
concept_clothing_pants	concept:clothingtogowithclothing	concept_clothing_sweaters
concept_agriculturalproduct_oysters	concept:arthropodcalledarthropod	concept_crustacean_crab
concept_jobposition_facility	concept:atdate	concept_date_n2001
concept_lake_new	concept:locationlocatedwithinlocation	concept_city_link
concept_artery_blood_vessels	concept:arterycalledartery	concept_artery_capillaries
concept_geopoliticallocation_show	concept:organizationdissolvedatdate	concept_month_march
concept_person_mark001	concept:persongraduatedfromuniversity	concept_university_college
concept_airport_europe	concept:atdate	concept_dateliteral_n2008
concept_weapon_missile	concept:weaponmadeincountry	concept_country_arabia_saudita
concept_politicsissue_public	concept:atdate	concept_dateliteral_n2002
concept_city_home	concept:atdate	concept_dateliteral_n2002
concept_country_philippines	concept:countrylocatedingeopoliticallocation	concept_geopoliticallocation_destinations
concept_agriculturalproduct_goats	concept:animalistypeofanimal	concept_mammal_small_animals
concept_city_parents	concept:atdate	concept_dateliteral_n2007
concept_country_armenia	concept:countryalsoknownas	concept_country_republic
concept_mammal_mammals	concept:animalpreyson	concept_mammal_bats
concept_jobposition_physician	concept:professionistypeofprofession	concept_profession_staff
concept_country_republic	concept:countryalsoknownas	concept_country_morocco
concept_automobilemaker_acura	concept:automobilemakerdealersincity	concept_city_san_diego
concept_sportsteam_packers	concept:teamplaysagainstteam	concept_sportsteam_new_york_giants
concept_visualizablething_use	concept:agentinvolvedwithitem	concept_buildingfeature_windows
concept_chemical_gas	concept:chemicalistypeofchemical	concept_chemical_sulphur
concept_clothing_hat	concept:clothingtogowithclothing	concept_visualizableobject_coat
concept_musicsong_sunday	concept:atdate	concept_dateliteral_n2007
concept_sportsteam_titans	concept:agentparticipatedinevent	concept_convention_games
concept_sportsteam_bucs	concept:teamplaysagainstteam	concept_sportsteam_new_york_giants
concept_wallitem_beginning	concept:atdate	concept_year_n1991
concept_city_club	concept:atdate	concept_dateliteral_n2007
concept_sportsteam_golden_state_warriors	concept:teamplaysagainstteam	concept_sportsteam_rockets
concept_sportsteam_orioles	concept:teamplaysagainstteam	concept_sportsteam_texas_rangers
concept_profession_associate	concept:atdate	concept_dateliteral_n2002
concept_governmentorganization_agency	concept:agentcollaborateswithagent	concept_monarch_property
concept_country_israel	concept:atdate	concept_dateliteral_n2007
concept_chemical_sulphur	concept:chemicalistypeofchemical	concept_chemical_organic_compounds
concept_retailstore_nbc	concept:atdate	concept_dateliteral_n2007
concept_programminglanguage_project	concept:atdate	concept_dateliteral_n2007
concept_programminglanguage_project	concept:atdate	concept_year_n1991
concept_mammal_elephants	concept:animalistypeofanimal	concept_mammal_mammals
concept_bodypart_tissue001	concept:bodypartcontainsbodypart	concept_artery_cord
concept_country_republic	concept:countryalsoknownas	concept_country_armenia
concept_sportsgame_championship	concept:sportsgameteam	concept_sportsteam_trail_blazers
concept_country_arabia_saudita	concept:countrylocatedingeopoliticallocation	concept_city_area
concept_mammal_small_animals	concept:animalistypeofanimal	concept_animal_birds002
concept_arthropod_seafood	concept:arthropodcalledarthropod	concept_crustacean_lobsters
concept_year_new	concept:mutualproxyfor	concept_county_san_diego
concept_animal_birds002	concept:agentcompeteswithagent	concept_animal_beasts
concept_company_new_york	concept:competeswith	concept_website_chicago_tribune
concept_sportsgame_playoffs	concept:sportsgameteam	concept_sportsteam_broncos
concept_automobilemaker_cadillac	concept:automobilemakerdealersincity	concept_city_san_antonio
concept_automobilemaker_toyota	concept:automobilemakerdealersincity	concept_city_denver
concept_bacteria_salmonella	concept:bacteriaisthecausativeagentofphysiologicalcondition	concept_disease_illness
concept_person_patrice_bergeron	concept:personbornincity	concept_city_york
concept_mammal_horses	concept:animalistypeofanimal	concept_animal_herbivores
concept_physicalaction_work	concept:atdate	concept_dateliteral_n2008
concept_city_resources	concept:locationlocatedwithinlocation	concept_stateorprovince_west_virginia
concept_country_morocco	concept:atdate	concept_dateliteral_n2008
concept_artery_cord	concept:bodypartcontainsbodypart	concept_artery_vessels
concept_mammal_pets	concept:animalpreyson	concept_mammal_kittens
concept_country_china	concept:atdate	concept_dateliteral_n2007
concept_athlete_j_p__ricciardi	concept:personalsoknownas	concept_athlete_j_p__arencibia
concept_book_stay	concept:atdate	concept_month_august
concept_county_columbus	concept:proxyfor	concept_emotion_mississippi
concept_sportsleague_mlb	concept:agentcontrols	concept_sportsteam_arizona_cardinals_27_23
concept_county_las_vegas	concept:atdate	concept_dateliteral_n2002
concept_city_washington_d_c	concept:subpartof	concept_country_usa
concept_coach_new	concept:subpartof	concept_city_washington_d_c
concept_person_james001	concept:agentcontrols	concept_charactertrait_world
concept_person_charles001	concept:personbornincity	concept_city_york
concept_website_chicago_tribune	concept:companyeconomicsector	concept_academicfield_news
concept_sportsteam_arizona_cardinals_27_23	concept:agentparticipatedinevent	concept_convention_games
concept_country_azerbaijan	concept:atdate	concept_dateliteral_n2007
concept_sportsteam_orioles	concept:teamplaysinleague	concept_sportsleague_mlb
concept_sportsteam_packers	concept:teamplaysagainstteam	concept_sportsteam_titans
concept_animal_animals002	concept:animalistypeofanimal	concept_animal_mice001
concept_politicianus_president_george_w__bush	concept:personbelongstoorganization	concept_governmentorganization_house
concept_city_madrid	concept:atdate	concept_dateliteral_n2007
concept_county_columbus	concept:atlocation	concept_stateorprovince_georgia
concept_website_new_york_times	concept:newspaperincity	concept_city_boston
concept_country_morocco	concept:atdate	concept_dateliteral_n2007
concept_politicsissue_public	concept:atdate	concept_year_n1992
concept_profession_accountants	concept:professionistypeofprofession	concept_profession_staff
concept_animal_links	concept:agentinvolvedwithitem	concept_buildingfeature_windows
concept_country_morocco	concept:countryalsoknownas	concept_country_republic
concept_sportsteam_rockets	concept:teamplaysagainstteam	concept_sportsteam_golden_state_warriors
concept_sportsequipment_board	concept:mutualproxyfor	concept_book_network
concept_athlete_carmelo_anthony	concept:personbelongstoorganization	concept_sportsleague_nba
concept_city_capital	concept:atdate	concept_dateliteral_n2007
concept_company_daily_news001	concept:headquarteredin	concept_county_los_angeles_county
concept_clothing_suit	concept:clothingtogowithclothing	concept_clothing_shoes
concept_mediatype_books	concept:atdate	concept_year_n1983
concept_sportsteam_chicago_white_sox	concept:teamplaysincity	concept_city_boston
concept_sportsteam_titans	concept:teamplaysagainstteam	concept_sportsteam_broncos
concept_website_amazon	concept:agentinvolvedwithitem	concept_buildingfeature_window
concept_county_los_angeles_county	concept:citylocatedincountry	concept_country_usa
concept_profession_lawyers	concept:atdate	concept_dateliteral_n2007
concept_sport_rugby	concept:sportschoolincountry	concept_country_new_zealand
concept_company_new_york	concept:competeswith	concept_televisionnetwork_abc
concept_sportsgame_championship	concept:sportsgameteam	concept_sportsteam_san_antonio
concept_sportsteam_anaheim_angels	concept:teamplaysagainstteam	concept_sportsteam_new_york_giants
concept_disease_breast_cancer	concept:atdate	concept_dateliteral_n2008
concept_sportsteam_florida_international	concept:teamplaysagainstteam	concept_sportsteam_new_york_giants
concept_stateorprovince_nevada	concept:atdate	concept_dateliteral_n2002
concept_animal_large_animals	concept:animalpreyson	concept_invertebrate_cattle
concept_governmentorganization_governments	concept:atdate	concept_dateliteral_n2007
concept_sportsteam_florida_international	concept:teamplaysagainstteam	concept_sportsteam_bucs
concept_weapon_weapons	concept:weaponmadeincountry	concept_country_usa
concept_clothing_shoes	concept:clothingtogowithclothing	concept_clothing_suit
concept_director_committee	concept:atdate	concept_dateliteral_n2008
concept_chemical_sulphur	concept:chemicalistypeofchemical	concept_chemical_particulate_matter
concept_weapon_national	concept:atlocation	concept_city_york
concept_island_operations	concept:atdate	concept_dateliteral_n2002
concept_island_operations	concept:atdate	concept_dateliteral_n2007
concept_language_russian	concept:languageofcountry	concept_country_czech_republic
concept_sportsteam_bears_29_17	concept:teamplaysagainstteam	concept_sportsteam_bills
concept_city_resources	concept:agentinvolvedwithitem	concept_buildingfeature_window
concept_chemical_organic_compounds	concept:chemicalistypeofchemical	concept_chemical_carbon
concept_sportsteam_new_york_giants	concept:teamplaysagainstteam	concept_sportsteam_florida_international
concept_book_network	concept:atdate	concept_dateliteral_n2008
concept_city_dallas	concept:atdate	concept_dateliteral_n2007
concept_automobilemaker_dodge	concept:automobilemakercardealersinstateorprovince	concept_stateorprovince_arizona
concept_city_new_york	concept:cityliesonriver	concept_river_hudson
concept_chemical_particulate_matter	concept:chemicalistypeofchemical	concept_chemical_sulfur
concept_city_web	concept:agentcompeteswithagent	concept_university_yahoo
concept_weapon_national	concept:atlocation	concept_county_san_diego
concept_sportsteam_pistons	concept:teamplaysagainstteam	concept_sportsteam_trail_blazers
concept_sportsteam_kansas_city_royals	concept:teamplaysincity	concept_city_boston
concept_city_dallas	concept:citylocatedingeopoliticallocation	concept_geopoliticallocation_national
concept_language_english	concept:languageofcountry	concept_country_czech_republic
concept_county_columbus	concept:subpartof	concept_emotion_mississippi
concept_country_china	concept:countryalsoknownas	concept_country_philippines
concept_animal_poultry	concept:animalpreyson	concept_bird_ducks
concept_sportsteam_bears_29_17	concept:teamplaysagainstteam	concept_sportsteam_broncos
concept_person_paul001	concept:personborninlocation	concept_city_york
concept_clothing_socks	concept:clothingtogowithclothing	concept_clothing_white_shirts
concept_country_republic	concept:countryalsoknownas	concept_country_romania
concept_city_zurich	concept:atdate	concept_dateliteral_n2007
concept_profession_specialists	concept:professionistypeofprofession	concept_jobposition_physician
concept_person_sri_lanka	concept:atdate	concept_dateliteral_n2008
concept_website_information	concept:atdate	concept_dateliteral_n2008
concept_mammal_pets	concept:animalpreyson	concept_mammal_monkeys
concept_sportsgame_championship	concept:sportsgameteam	concept_sportsteam_longhorns
concept_language_spanish	concept:languageofcountry	concept_country_philippines
concept_country_mozambique	concept:atdate	concept_dateliteral_n2007
concept_politicianus_george_w__bush	concept:politicianusmemberofpoliticalgroup	concept_governmentorganization_house
concept_website_decision	concept:atdate	concept_dateliteral_n2008
concept_year_new	concept:subpartof	concept_stateorprovince_georgia
concept_website_kenya	concept:atdate	concept_dateliteral_n2002
concept_sportsteam_florida_international	concept:teamplaysagainstteam	concept_sportsteam_packers
concept_city_dublin_dublin	concept:citylocatedingeopoliticallocation	concept_country_republic
concept_island_operations	concept:atdate	concept_year_n1983
concept_website_washington_times	concept:headquarteredin	concept_city_washington_d_c
concept_mammal_small_animals	concept:animalpreyson	concept_mammal_pets
concept_sportsgame_championship	concept:sportsgameteam	concept_sportsteam_pistons
concept_city_web	concept:atdate	concept_dateliteral_n2008
concept_crustacean_shellfish	concept:arthropodcalledarthropod	concept_crustacean_shrimp
concept_person_charles001	concept:personborninlocation	concept_city_york
concept_clothing_hats	concept:clothingtogowithclothing	concept_clothing_shoes
concept_country_philippines	concept:countryalsoknownas	concept_country_republic
concept_sport_track	concept:sportfansincountry	concept_country_usa
concept_company_case	concept:atdate	concept_year_n1992
concept_profession_specialists	concept:professionistypeofprofession	concept_profession_nurses
concept_mammal_canines	concept:animalistypeofanimal	concept_mammal_dog
concept_mammal_pets	concept:animalistypeofanimal	concept_mammal_small_animals
concept_monarch_property	concept:agentcollaborateswithagent	concept_governmentorganization_agency
concept_sportsteam_new_york_giants	concept:teamplaysagainstteam	concept_sportsteam_detroit_lions
concept_city_home	concept:atlocation	concept_stateorprovince_arizona
concept_director_committee	concept:atdate	concept_dateliteral_n2002
concept_mammal_mammals	concept:animalistypeofanimal	concept_agriculturalproduct_goats
concept_country_brazil	concept:countryalsoknownas	concept_country_republic
concept_mammal_antelope	concept:animalistypeofanimal	concept_mammal_mammals
concept_televisionnetwork_abc	concept:hasofficeincity	concept_city_washington_d_c
concept_eventoutcome_practice	concept:atdate	concept_dateliteral_n2007
concept_city_berlin	concept:atdate	concept_dateliteral_n2008
concept_country_armenia	concept:atdate	concept_dateliteral_n2007
concept_chemical_sulfur	concept:chemicalistypeofchemical	concept_chemical_carbon
concept_country_u_s_	concept:countryalsoknownas	concept_country_republic
concept_sportsteam_titans	concept:teamplaysagainstteam	concept_sportsteam_bears_29_17
concept_city_link	concept:agentinvolvedwithitem	concept_buildingfeature_window
concept_website_washington_times	concept:companyeconomicsector	concept_academicfield_news
concept_sportsteam_packers	concept:teamplaysagainstteam	concept_sportsteam_broncos
concept_politicsissue_public	concept:atdate	concept_dateliteral_n2007
concept_biotechcompany_white	concept:agentcollaborateswithagent	concept_governmentorganization_house
concept_website_performance	concept:atdate	concept_dateliteral_n2008
concept_sportsgame_championship	concept:atdate	concept_dayofweek_saturday
concept_company_case	concept:agentinvolvedwithitem	concept_buildingfeature_window
concept_sportsteam_florida_international	concept:teamplaysagainstteam	concept_sportsteam_broncos
